Size,Time,Cycles,Price,Instructions,HeapSize,TotalHeapSize
1,2064110333,79038132,1.067014782e-11,5543,1025396,1026040
2,2043547750,79144987,1.0684573244999999e-11,6142,-1280,1024760
3,2051799541,79038658,1.067021883e-11,6142,1025408,2050168
4,2051242833,79251552,1.0698959519999999e-11,6681,-1176,2048992
5,2032800542,79038165,1.0670152275e-11,6681,1025408,3074400
6,2062727083,79038165,1.0670152275e-11,6681,1025408,4099808
7,2039847792,79411377,1.0720535894999999e-11,6681,-514468,3585340
8,2061621208,79039204,1.0670292540000002e-11,7220,1025408,4610748
9,2047151750,79038181,1.0670154435e-11,7220,1025408,5636156
10,2039727500,79571215,1.0742114025e-11,7220,-514468,5121688
11,2059977583,79038179,1.0670154165e-11,7157,1025408,6147096
12,2350185750,79038180,1.0670154299999999e-11,7178,1025408,7172504
13,2118952125,79039483,1.0670330205e-11,7178,1025408,8197912
14,2991060000,79784313,1.0770882254999999e-11,7199,-1027760,7170152
15,2055588916,79038181,1.0670154435e-11,7199,1025408,8195560
16,2056994958,79038197,1.0670156594999999e-11,7738,1025408,9220968
17,2049058792,79039917,1.0670388795e-11,7738,1025408,10246376
18,2049698875,79038197,1.0670156594999999e-11,7738,1025408,11271784
19,2134210875,80050702,1.0806844770000001e-11,7738,-1541052,9730732
20,2049538541,79038197,1.0670156594999999e-11,7738,1025408,10756140
21,2050537417,79040428,1.0670457779999999e-11,7675,1025408,11781548
22,2049803916,79038196,1.067015646e-11,7696,1025408,12806956
23,2122768583,79038197,1.0670156594999999e-11,7717,1025408,13832364
24,2054729084,79038197,1.0670156594999999e-11,7717,1025408,14857772
25,2103824292,80370347,1.0849996844999998e-11,7717,-2054344,12803428
26,2081206125,79041038,1.067054013e-11,7717,1025408,13828836
27,2062690625,79038197,1.0670156594999999e-11,7738,1025408,14854244
28,2050550959,79038197,1.0670156594999999e-11,7738,1025408,15879652
29,2104625292,79038197,1.0670156594999999e-11,7738,1025408,16905060
30,2049734375,79038197,1.0670156594999999e-11,7738,1025408,17930468
31,2107102000,79041036,1.067053986e-11,7675,1025408,18955876
32,2037624833,79038790,1.067023665e-11,27002,1026232,19982108
33,2107989875,80796839,1.0907573265e-11,8674,-3081236,16900872
34,2062013000,79038226,1.067016051e-11,8674,1025432,17926304
35,2051728583,79038227,1.0670160645000001e-11,8695,1025432,18951736
36,2050584000,79041903,1.0670656905e-11,8695,1025432,19977168
37,2105420500,79038227,1.0670160645000001e-11,8695,1025432,21002600
38,2051610542,79038227,1.0670160645000001e-11,8695,1025432,22028032
39,2111466500,79038227,1.0670160645000001e-11,8695,1025432,23053464
40,2053559375,79038227,1.0670160645000001e-11,8695,1025432,24078896
41,2109711167,79041901,1.0670656635e-11,8632,1025432,25104328
42,2049660292,79038225,1.0670160374999998e-11,8653,1025432,26129760
43,3336212250,81329583,1.0979493705e-11,8653,-4107728,22022032
44,3284700416,79038226,1.067016051e-11,8674,1025432,23047464
45,2122604042,79042928,1.067079528e-11,8674,1025432,24072896
46,2059488292,79038226,1.067016051e-11,8674,1025432,25098328
47,3269230959,79038226,1.067016051e-11,8674,1025432,26123760
48,3264487208,79038227,1.0670160645000001e-11,8695,1025432,27149192
49,4724530291,79043416,1.067086116e-11,24545,1025880,28175072
50,2049081125,79038227,1.0670160645000001e-11,8716,1025432,29200504
51,2049783333,79038225,1.0670160374999998e-11,8632,1025432,30225936
52,2049252833,79038225,1.0670160374999998e-11,8653,1025432,31251368
53,2049380416,79042928,1.067079528e-11,8674,1025432,32276800
54,3266450833,79038226,1.067016051e-11,8674,1025432,33302232
55,3323786375,81968981,1.1065812435e-11,8674,-5134620,28167612
56,2070719833,79038227,1.0670160645000001e-11,8695,1025432,29193044
57,2114494292,79044145,1.0670959575000001e-11,8695,1025432,30218476
58,2062200042,79038227,1.0670160645000001e-11,8695,1025432,31243908
59,2050158334,79038227,1.0670160645000001e-11,8695,1025432,32269340
60,2049769541,79038227,1.0670160645000001e-11,8695,1025432,33294772
61,2087625375,79044143,1.0670959304999998e-11,8632,1025432,34320204
62,9191640750,79038225,1.0670160374999998e-11,8653,1025432,35345636
63,2063381333,79044143,1.0670959304999998e-11,8653,1025432,36371068
64,2051691125,79038226,1.067016051e-11,8674,1025432,37396500
65,2050157125,79038226,1.067016051e-11,8674,1025432,38421932
66,2063205416,79038709,1.0670225715000001e-11,24392,1025880,39447812
67,2062221958,79044161,1.0670961734999999e-11,9213,1025432,40473244
68,2068737750,79038243,1.0670162804999999e-11,9213,1025432,41498676
69,2117427750,79038243,1.0670162804999999e-11,9213,1025432,42524108
70,3271218833,82768220,1.11737097e-11,9234,-6674568,35849540
71,2044770666,79038241,1.0670162535e-11,9150,1025432,36874972
72,2051099000,79045691,1.0671168285e-11,9171,1025432,37900404
73,2061093791,79038242,1.0670162670000002e-11,9192,1025432,38925836
74,2066926125,79038242,1.0670162670000002e-11,9192,1025432,39951268
75,2051970208,79038242,1.0670162670000002e-11,9192,1025432,40976700
76,2061121209,79045692,1.067116842e-11,9192,1025432,42002132
77,2053407375,79038243,1.0670162804999999e-11,9213,1025432,43027564
78,3283336708,79038243,1.0670162804999999e-11,9213,1025432,44052996
79,2051937750,79038243,1.0670162804999999e-11,9213,1025432,45078428
80,2051206208,79038243,1.0670162804999999e-11,9213,1025432,46103860
81,2050559750,79045691,1.0671168285e-11,9150,1025432,47129292
82,2050498042,79038241,1.0670162535e-11,9171,1025432,48154724
83,2052181792,79038721,1.0670227335e-11,24757,1025880,49180604
84,2057368625,79038242,1.0670162670000002e-11,9192,1025432,50206036
85,2050770500,79038243,1.0670162804999999e-11,9213,1025432,51231468
86,2125314083,79045693,1.0671168555e-11,9213,1025432,52256900
87,2050491791,79038243,1.0670162804999999e-11,9213,1025432,53282332
88,2052894333,79038243,1.0670162804999999e-11,9213,1025432,54307764
89,3272034625,83780540,1.13103729e-11,9213,-8727832,45579932
90,2368106750,79047655,1.0671433425e-11,9213,1025432,46605364
91,2688131208,79038241,1.0670162535e-11,9150,1025432,47630796
92,2563038792,79038241,1.0670162535e-11,9171,1025432,48656228
93,2055200375,79038241,1.0670162535e-11,9171,1025432,49681660
94,2058691125,79047654,1.0671433290000001e-11,9192,1025432,50707092
95,2142926083,79038242,1.0670162670000002e-11,9192,1025432,51732524
96,2048909750,79038242,1.0670162670000002e-11,9192,1025432,52757956
97,2050315542,79038242,1.0670162670000002e-11,9192,1025432,53783388
98,2051206625,79038243,1.0670162804999999e-11,9213,1025432,54808820
99,3271254750,79048596,1.0671560460000001e-11,9213,1025432,55834252
100,2055350917,79038718,1.067022693e-11,24667,1025880,56860132
101,2109894917,79038237,1.0670161995e-11,9024,1025432,57885564
102,2121631708,79038238,1.067016213e-11,9066,1025432,58910996
103,2062828166,79038239,1.0670162265e-11,9108,1025432,59936428
104,2051412875,79047651,1.0671432885000001e-11,9108,1025432,60961860
105,2063004792,79038239,1.0670162265e-11,9108,1025432,61987292
106,2063476625,79038241,1.0670162535e-11,9150,1025432,63012724
107,2084545458,79038241,1.0670162535e-11,9150,1025432,64038156
108,2080103333,79038241,1.0670162535e-11,9150,1025432,65063588
109,2098002541,79047653,1.0671433155e-11,9150,1025432,66089020
110,2050622792,79038241,1.0670162535e-11,9150,1025432,67114452
111,2059317334,79038239,1.0670162265e-11,9087,1025432,68139884
112,2060925250,79038239,1.0670162265e-11,9108,1025432,69165316
113,3297430375,85071110,1.148459985e-11,9108,-11294412,57870904
114,2054385667,79038240,1.0670162399999999e-11,9129,1025432,58896336
115,2050656916,79038240,1.0670162399999999e-11,9129,1025432,59921768
116,2132201583,79038241,1.0670162535e-11,9150,1025432,60947200
117,2104617750,79038712,1.067022612e-11,24472,1025880,61973080
118,3340363500,79050123,1.0671766605e-11,9192,1025432,62998512
119,2060452875,79038243,1.0670162804999999e-11,9213,1025432,64023944
120,2050429375,79038243,1.0670162804999999e-11,9213,1025432,65049376
121,2051702042,79038240,1.0670162399999999e-11,9129,1025432,66074808
122,2048837000,79050122,1.067176647e-11,9150,1025432,67100240
123,2097280583,79038241,1.0670162535e-11,9171,1025432,68125672
124,6481392167,79038241,1.0670162535e-11,9171,1025432,69151104
125,2081916666,79050122,1.067176647e-11,9171,1025432,70176536
126,2070032625,79038241,1.0670162535e-11,9171,1025432,71201968
127,2068943167,79038242,1.0670162670000002e-11,9192,1025432,72227400
128,2061596333,79038242,1.0670162670000002e-11,9192,1025432,73252832
129,2080214750,79038242,1.0670162670000002e-11,9192,1025432,74278264
130,2076457042,79050123,1.0671766605e-11,9192,1025432,75303696
131,3356151458,79038240,1.0670162399999999e-11,9129,1025432,76329128
132,2469003959,79038241,1.0670162535e-11,9150,1025432,77354560
133,3112052584,79038241,1.0670162535e-11,9150,1025432,78379992
134,2679894209,79050589,1.0671829515e-11,24340,1025880,79405872
135,2050520583,79038258,1.067016483e-11,9710,1025432,80431304
136,2053241334,79038258,1.067016483e-11,9710,1025432,81456736
137,2049343959,79050139,1.0671768764999998e-11,9710,1025432,82482168
138,2049592834,79038258,1.067016483e-11,9710,1025432,83507600
139,2049988042,79038258,1.067016483e-11,9710,1025432,84533032
140,3272143000,79038258,1.067016483e-11,9710,1025432,85558464
141,2095932750,79050137,1.0671768494999999e-11,9647,1025432,86583896
142,2034269375,79038257,1.0670164695e-11,9668,1025432,87609328
143,3348916833,86657689,1.1698788015e-11,9668,-14374568,73234760
144,2039018834,79038257,1.0670164695e-11,9689,1025432,74260192
145,2047865500,79038257,1.0670164695e-11,9689,1025432,75285624
146,2049202292,79053214,1.067218389e-11,9689,1025432,76311056
147,2053363625,79038257,1.0670164695e-11,9689,1025432,77336488
148,2050882416,79038258,1.067016483e-11,9710,1025432,78361920
149,2093724959,79038258,1.067016483e-11,9710,1025432,79387352
150,2078801333,79053215,1.0672184025e-11,9710,1025432,80412784
151,2251777500,79038719,1.0670227065e-11,24684,1025880,81438664
152,2309147250,79038257,1.0670164695e-11,9668,1025432,82464096
153,3019951500,79038257,1.0670164695e-11,9689,1025432,83489528
154,2502902125,79053214,1.067218389e-11,9689,1025432,84514960
155,6475727916,79038258,1.067016483e-11,9710,1025432,85540392
156,2049668166,79038258,1.067016483e-11,9710,1025432,86565824
157,2049891417,79053215,1.0672184025e-11,9710,1025432,87591256
158,2049544167,79038258,1.067016483e-11,9710,1025432,88616688
159,2050478708,79038258,1.067016483e-11,9710,1025432,89642120
160,2047083500,79038258,1.067016483e-11,9710,1025432,90667552
161,2071683500,79053213,1.0672183755e-11,9647,1025432,91692984
162,2061077208,79038257,1.0670164695e-11,9668,1025432,92718416
163,2098372292,79038257,1.0670164695e-11,9668,1025432,93743848
164,2062287584,79038257,1.0670164695e-11,9689,1025432,94769280
165,2077132625,79038257,1.0670164695e-11,9689,1025432,95794712
166,3293705750,79053214,1.067218389e-11,9689,1025432,96820144
167,2062229208,79038257,1.0670164695e-11,9689,1025432,97845576
168,2061660208,79038717,1.0670226794999999e-11,24615,1025880,98871456
169,2081851041,79038258,1.067016483e-11,9731,1025432,99896888
170,2061609958,79038258,1.067016483e-11,9731,1025432,100922320
171,2059100958,79053213,1.0672183755e-11,9647,1025432,101947752
172,2094798792,79038257,1.0670164695e-11,9668,1025432,102973184
173,2120397583,79038257,1.0670164695e-11,9689,1025432,103998616
174,2061199709,79038257,1.0670164695e-11,9689,1025432,105024048
175,2101127959,79038257,1.0670164695e-11,9689,1025432,106049480
176,2065520334,79053215,1.0672184025e-11,9710,1025432,107074912
177,2094089583,79038258,1.067016483e-11,9710,1025432,108100344
178,2057422666,79038258,1.067016483e-11,9710,1025432,109125776
179,2049687291,79038258,1.067016483e-11,9710,1025432,110151208
180,6500222000,88647785,1.1967450975e-11,9710,-17967780,92183428
181,2060295375,79038256,1.067016456e-11,9647,1025432,93208860
182,2119598416,79038257,1.0670164695e-11,9668,1025432,94234292
183,2059802500,79038257,1.0670164695e-11,9668,1025432,95259724
184,3264337208,79056989,1.0672693515e-11,9689,1025432,96285156
185,2049520375,79038713,1.0670226255e-11,24483,1025880,97311036
186,2049945459,79038258,1.067016483e-11,9731,1025432,98336468
187,2051025000,79038258,1.067016483e-11,9731,1025432,99361900
188,2052704166,79056990,1.067269365e-11,9731,1025432,100387332
189,2048923500,79038258,1.067016483e-11,9731,1025432,101412764
190,3265903125,79038258,1.067016483e-11,9731,1025432,102438196
191,2145160917,79038257,1.0670164695e-11,9668,1025432,103463628
192,2237858125,79056989,1.0672693515e-11,9689,1025432,104489060
193,2519746625,79038258,1.067016483e-11,9710,1025432,105514492
194,11502902417,79056990,1.067269365e-11,9710,1025432,106539924
195,2051494167,79038258,1.067016483e-11,9710,1025432,107565356
196,2048966459,79038258,1.067016483e-11,9710,1025432,108590788
197,3314830833,79056990,1.067269365e-11,9731,1025432,109616220
198,2052373708,79038258,1.067016483e-11,9731,1025432,110641652
199,2049638792,79038258,1.067016483e-11,9731,1025432,111667084
200,2073804583,79038258,1.067016483e-11,9731,1025432,112692516
201,2061613625,79056984,1.0672692840000001e-11,9521,1025432,113717948
202,2131050750,79038703,1.0670224904999999e-11,24183,1025880,114743828
203,2057505583,79038255,1.0670164424999999e-11,9605,1025432,115769260
204,2051854583,79038255,1.0670164424999999e-11,9605,1025432,116794692
205,2051721417,79038256,1.067016456e-11,9647,1025432,117820124
206,2051213500,79056988,1.067269338e-11,9647,1025432,118845556
207,2048449792,79038256,1.067016456e-11,9647,1025432,119870988
208,2062800667,79038256,1.067016456e-11,9647,1025432,120896420
209,2049689958,79038256,1.067016456e-11,9647,1025432,121921852
210,2105022667,79038256,1.067016456e-11,9647,1025432,122947284
211,2049368875,79056986,1.067269311e-11,9584,1025432,123972716
212,2070024625,79038255,1.0670164424999999e-11,9605,1025432,124998148
213,2050776250,79038255,1.0670164424999999e-11,9605,1025432,126023580
214,2049692875,79038256,1.067016456e-11,9647,1025432,127049012
215,2049497625,79038256,1.067016456e-11,9647,1025432,128074444
216,2049434333,79056988,1.067269338e-11,9647,1025432,129099876
217,2050353208,79038256,1.067016456e-11,9647,1025432,130125308
218,2055759500,79038257,1.0670164695e-11,9668,1025432,131150740
219,2049585459,79038704,1.0670225040000001e-11,24198,1025880,132176620
220,2050940334,79038258,1.067016483e-11,9710,1025432,133202052
221,2051288875,79056987,1.0672693245e-11,9626,1025432,134227484
222,2043245208,79038256,1.067016456e-11,9647,1025432,135252916
223,2142999375,79038257,1.0670164695e-11,9668,1025432,136278348
224,2038254500,79038257,1.0670164695e-11,9668,1025432,137303780
225,2050064333,79038257,1.0670164695e-11,9668,1025432,138329212
226,2050069916,79056989,1.0672693515e-11,9689,1025432,139354644
227,6530295917,91133269,1.2302991315000001e-11,9689,-23101200,116253444
228,2061250500,79038257,1.0670164695e-11,9689,1025432,117278876
229,2137669209,79061836,1.067334786e-11,9689,1025432,118304308
230,6456718083,79038257,1.0670164695e-11,9689,1025432,119329740
231,2051860750,79038255,1.0670164424999999e-11,9626,1025432,120355172
232,3265077209,79061835,1.0673347725e-11,9647,1025432,121380604
233,2049493500,79038256,1.067016456e-11,9647,1025432,122406036
234,2051300125,79038257,1.0670164695e-11,9668,1025432,123431468
235,3265609209,79038257,1.0670164695e-11,9668,1025432,124456900
236,3266401084,79038700,1.0670224499999999e-11,24066,1025880,125482780
237,2050903458,79038257,1.0670164695e-11,9689,1025432,126508212
238,2050802542,79038257,1.0670164695e-11,9689,1025432,127533644
239,2049781541,79038257,1.0670164695e-11,9689,1025432,128559076
240,2050441416,79061837,1.0673347995000001e-11,9710,1025432,129584508
241,22753108250,79090129,1.0677167415e-11,9626,1025432,130609940
242,2050919541,79038256,1.067016456e-11,9647,1025432,131635372
243,2053150958,79038257,1.0670164695e-11,9668,1025432,132660804
244,2052565834,79038257,1.0670164695e-11,9668,1025432,133686236
245,2054576500,79061836,1.067334786e-11,9668,1025432,134711668
246,2063475250,79038257,1.0670164695e-11,9668,1025432,135737100
247,2115938459,79038257,1.0670164695e-11,9689,1025432,136762532
248,2064263875,79038257,1.0670164695e-11,9689,1025432,137787964
249,2052146167,79038257,1.0670164695e-11,9689,1025432,138813396
250,2050608958,79061836,1.067334786e-11,9689,1025432,139838828
251,2055385958,79038255,1.0670164424999999e-11,9626,1025432,140864260
252,2052732208,79038256,1.067016456e-11,9647,1025432,141889692
253,2059598916,79038695,1.0670223825e-11,23913,1025880,142915572
254,2054132792,79038257,1.0670164695e-11,9689,1025432,143941004
255,2051524875,79061837,1.0673347995000001e-11,9710,1025432,144966436
256,2054911958,79038258,1.067016483e-11,9710,1025432,145991868
257,2072157917,79038258,1.067016483e-11,9710,1025432,147017300
258,2053132125,79038258,1.067016483e-11,9710,1025432,148042732
259,2055910000,79038258,1.067016483e-11,9710,1025432,149068164
260,2417219625,79061837,1.0673347995000001e-11,9710,1025432,150093596
261,3806371834,79038256,1.067016456e-11,9647,1025432,151119028
262,3138533666,79038257,1.0670164695e-11,9668,1025432,152144460
263,2047727292,79061836,1.067334786e-11,9668,1025432,153169892
264,2050744292,79038257,1.0670164695e-11,9689,1025432,154195324
265,2049640709,79038257,1.0670164695e-11,9689,1025432,155220756
266,2050624292,79038257,1.0670164695e-11,9689,1025432,156246188
267,2049112208,79038257,1.0670164695e-11,9689,1025432,157271620
268,2051880667,79061837,1.0673347995000001e-11,9710,1025432,158297052
269,3274386417,79038258,1.067016483e-11,9710,1025432,159322484
270,2053236041,79038693,1.0670223555e-11,23844,1025880,160348364
271,2055268750,79038272,1.067016672e-11,10165,1025432,161373796
272,2049887500,79061852,1.0673350020000001e-11,10186,1025432,162399228
273,2050583875,79038273,1.0670166855e-11,10207,1025432,163424660
274,2050832542,79038273,1.0670166855e-11,10207,1025432,164450092
275,2049385166,79038273,1.0670166855e-11,10207,1025432,165475524
276,2118177958,79038274,1.067016699e-11,10228,1025432,166500956
277,2050391458,79061853,1.0673350154999999e-11,10228,1025432,167526388
278,2051492917,79038274,1.067016699e-11,10228,1025432,168551820
279,2050143333,79038274,1.067016699e-11,10228,1025432,169577252
280,2051036291,79038274,1.067016699e-11,10228,1025432,170602684
281,2050567833,79061851,1.0673349884999999e-11,10165,1025432,171628116
282,2054634334,79038273,1.0670166855e-11,10186,1025432,172653548
283,2050679083,79038273,1.0670166855e-11,10186,1025432,173678980
284,3153134250,79038273,1.0670166855e-11,10207,1025432,174704412
285,15373744083,94282516,1.2728139660000001e-11,10207,-28747676,145956736
286,2052062417,79038273,1.0670166855e-11,10207,1025432,146982168
287,2055978959,79038704,1.0670225040000001e-11,24209,1025880,148008048
288,2058763125,79038274,1.067016699e-11,10228,1025432,149033480
289,2049314125,79038274,1.067016699e-11,10249,1025432,150058912
290,2063451166,79038274,1.067016699e-11,10249,1025432,151084344
291,2048275625,79038272,1.067016672e-11,10165,1025432,152109776
292,2052609208,79038273,1.0670166855e-11,10186,1025432,153135208
293,2090881041,79038273,1.0670166855e-11,10207,1025432,154160640
294,2060842917,79067773,1.0674149355e-11,10207,1025432,155186072
295,2084214250,79038273,1.0670166855e-11,10207,1025432,156211504
296,2080920834,79038273,1.0670166855e-11,10207,1025432,157236936
297,2060146250,79038274,1.067016699e-11,10228,1025432,158262368
298,2078273375,79038274,1.067016699e-11,10228,1025432,159287800
299,2093870416,79067774,1.067414949e-11,10228,1025432,160313232
300,2071295209,79038274,1.067016699e-11,10228,1025432,161338664
301,17733296333,79097267,1.0678131045e-11,10018,1025432,162364096
302,2098705250,79038269,1.0670166315e-11,10060,1025432,163389528
303,2068034292,79038269,1.0670166315e-11,10060,1025432,164414960
304,2488995416,79038695,1.0670223825e-11,23930,1025880,165440840
305,2436486209,79067771,1.0674149085e-11,10144,1025432,166466272
306,2540185334,79038271,1.0670166585e-11,10144,1025432,167491704
307,2142751958,79038271,1.0670166585e-11,10144,1025432,168517136
308,2059525833,79038271,1.0670166585e-11,10144,1025432,169542568
309,2047398583,79067771,1.0674149085e-11,10144,1025432,170568000
310,2132430917,79038271,1.0670166585e-11,10144,1025432,171593432
311,2075339834,79038269,1.0670166315e-11,10081,1025432,172618864
312,2079695625,79038271,1.0670166585e-11,10123,1025432,173644296
313,2220222583,79038271,1.0670166585e-11,10123,1025432,174669728
314,8588408583,79067771,1.0674149085e-11,10144,1025432,175695160
315,2060490875,79067771,1.0674149085e-11,10144,1025432,176720592
316,2051114917,79038271,1.0670166585e-11,10144,1025432,177746024
317,2062185541,79038271,1.0670166585e-11,10144,1025432,178771456
318,2059497834,79038272,1.067016672e-11,10165,1025432,179796888
319,2082455000,79038272,1.067016672e-11,10165,1025432,180822320
320,2057087083,79067772,1.067414922e-11,10165,1025432,181847752
321,2097470875,79038692,1.067022342e-11,23819,1025880,182873632
322,2054873250,79038271,1.0670166585e-11,10144,1025432,183899064
323,2133934041,79038272,1.067016672e-11,10165,1025432,184924496
324,2052090375,79038272,1.067016672e-11,10165,1025432,185949928
325,2154847041,79067773,1.0674149355e-11,10186,1025432,186975360
326,2079802292,79038273,1.0670166855e-11,10186,1025432,188000792
327,2282618792,79038273,1.0670166855e-11,10186,1025432,189026224
328,2449924375,79038273,1.0670166855e-11,10186,1025432,190051656
329,3528035208,79067773,1.0674149355e-11,10186,1025432,191077088
330,3141831834,79038273,1.0670166855e-11,10186,1025432,192102520
331,2145397667,79038271,1.0670166585e-11,10123,1025432,193127952
332,2072489666,79038271,1.0670166585e-11,10144,1025432,194153384
333,2077011250,79067771,1.0674149085e-11,10144,1025432,195178816
334,2072622584,79038272,1.067016672e-11,10165,1025432,196204248
335,2097908500,79038272,1.067016672e-11,10165,1025432,197229680
336,2062075625,79038272,1.067016672e-11,10165,1025432,198255112
337,2085095208,79067772,1.067414922e-11,10165,1025432,199280544
338,2054917083,79038690,1.067022315e-11,23771,1025880,200306424
339,2098009125,79038274,1.067016699e-11,10228,1025432,201331856
340,2086656917,79038274,1.067016699e-11,10228,1025432,202357288
341,2095697875,79038271,1.0670166585e-11,10144,1025432,203382720
342,2054554416,79067772,1.067414922e-11,10165,1025432,204408152
343,2088901833,79038273,1.0670166855e-11,10186,1025432,205433584
344,2085486834,79038273,1.0670166855e-11,10186,1025432,206459016
345,2091934250,79038273,1.0670166855e-11,10186,1025432,207484448
346,2061723583,79038273,1.0670166855e-11,10207,1025432,208509880
347,2086650583,79067773,1.0674149355e-11,10207,1025432,209535312
348,2074142542,79038273,1.0670166855e-11,10207,1025432,210560744
349,2088879583,79038273,1.0670166855e-11,10207,1025432,211586176
350,2072924250,79038273,1.0670166855e-11,10207,1025432,212611608
351,2705918666,79067771,1.0674149085e-11,10144,1025432,213637040
352,2537321125,79038272,1.067016672e-11,10165,1025432,214662472
353,3742704667,79038272,1.067016672e-11,10165,1025432,215687904
354,2054502583,79067773,1.0674149355e-11,10186,1025432,216713336
355,2051704542,79038687,1.0670222744999998e-11,23660,1025880,217739216
356,2050090000,79038273,1.0670166855e-11,10207,1025432,218764648
357,2052259958,79038273,1.0670166855e-11,10207,1025432,219790080
358,6529959083,98113077,1.3245265395e-11,10207,-36447936,183342144
359,2049980625,79075274,1.067516199e-11,10207,1025432,184367576
360,2038025750,79038273,1.0670166855e-11,10207,1025432,185393008
361,2159087042,79038271,1.0670166585e-11,10144,1025432,186418440
362,2118107583,79075273,1.0675161855000001e-11,10165,1025432,187443872
363,2085608584,79038273,1.0670166855e-11,10186,1025432,188469304
364,2051746583,79038273,1.0670166855e-11,10186,1025432,189494736
365,2050668041,79038273,1.0670166855e-11,10186,1025432,190520168
366,2057471416,79038273,1.0670166855e-11,10186,1025432,191545600
367,2073153667,79075274,1.067516199e-11,10207,1025432,192571032
368,2050073792,79038273,1.0670166855e-11,10207,1025432,193596464
369,6478355958,79038273,1.0670166855e-11,10207,1025432,194621896
370,2051694167,79075274,1.067516199e-11,10207,1025432,195647328
371,2088227333,79038271,1.0670166585e-11,10144,1025432,196672760
372,2099886875,79038682,1.0670222069999999e-11,23486,1025880,197698640
373,2051481334,79038273,1.0670166855e-11,10186,1025432,198724072
374,2052310916,79075274,1.067516199e-11,10186,1025432,199749504
375,2054431833,79038273,1.0670166855e-11,10207,1025432,200774936
376,2072771709,79038273,1.0670166855e-11,10207,1025432,201800368
377,2714707417,79038273,1.0670166855e-11,10207,1025432,202825800
378,3192718667,79075274,1.067516199e-11,10207,1025432,203851232
379,3056118917,79038273,1.0670166855e-11,10207,1025432,204876664
380,2060103416,79038273,1.0670166855e-11,10207,1025432,205902096
381,21991924459,79130775,1.0682654625e-11,10144,1025432,206927528
382,2050956541,79038272,1.067016672e-11,10165,1025432,207952960
383,2049194250,79038272,1.067016672e-11,10165,1025432,208978392
384,2110280833,79038273,1.0670166855e-11,10186,1025432,210003824
385,2062697458,79075274,1.067516199e-11,10186,1025432,211029256
386,2123756000,79038273,1.0670166855e-11,10186,1025432,212054688
387,2057009042,79038273,1.0670166855e-11,10186,1025432,213080120
388,2056571166,79038273,1.0670166855e-11,10207,1025432,214105552
389,2050076334,79038680,1.0670221799999999e-11,23417,1025880,215131432
390,2063133333,79075275,1.0675162125e-11,10249,1025432,216156864
391,2051398917,79038272,1.067016672e-11,10165,1025432,217182296
392,2051093708,79038273,1.0670166855e-11,10186,1025432,218207728
393,2053089208,79038273,1.0670166855e-11,10207,1025432,219233160
394,2049017708,79038273,1.0670166855e-11,10207,1025432,220258592
395,2053233042,79075274,1.067516199e-11,10207,1025432,221284024
396,2094175792,79038274,1.067016699e-11,10228,1025432,222309456
397,2113857792,79038274,1.067016699e-11,10228,1025432,223334888
398,2059657250,79038274,1.067016699e-11,10228,1025432,224360320
399,2272539875,79038274,1.067016699e-11,10228,1025432,225385752
400,3974845541,79038274,1.067016699e-11,10228,1025432,226411184
401,2867001458,79038267,1.0670166045000001e-11,10018,1025432,227436616
402,2116012083,79038269,1.0670166315e-11,10060,1025432,228462048
403,2072908500,79038269,1.0670166315e-11,10060,1025432,229487480
404,2049313250,79038270,1.067016645e-11,10102,1025432,230512912
405,2115253584,79038270,1.067016645e-11,10102,1025432,231538344
406,2100630708,79038672,1.067022072e-11,23180,1025880,232564224
407,2048164125,79075272,1.067516172e-11,10144,1025432,233589656
408,2143276166,79038271,1.0670166585e-11,10144,1025432,234615088
409,2111580542,79038271,1.0670166585e-11,10144,1025432,235640520
410,2063322791,79038273,1.0670166855e-11,10186,1025432,236665952
411,2093043750,79038270,1.067016645e-11,10102,1025432,237691384
412,2067045833,79075272,1.067516172e-11,10123,1025432,238716816
413,2078349833,79038271,1.0670166585e-11,10144,1025432,239742248
414,2057542708,79038271,1.0670166585e-11,10144,1025432,240767680
415,2084504250,79038271,1.0670166585e-11,10144,1025432,241793112
416,2062061667,79075272,1.067516172e-11,10144,1025432,242818544
417,2141405417,79038272,1.067016672e-11,10165,1025432,243843976
418,2049996792,79038272,1.067016672e-11,10165,1025432,244869408
419,2078775917,79038272,1.067016672e-11,10165,1025432,245894840
420,2057525584,79038272,1.067016672e-11,10165,1025432,246920272
421,2105744208,79075271,1.0675161585000001e-11,10102,1025432,247945704
422,2123286709,79038271,1.0670166585e-11,10123,1025432,248971136
423,2355515708,79038669,1.0670220315000001e-11,23069,1025880,249997016
424,2355794916,79038272,1.067016672e-11,10165,1025432,251022448
425,2473627000,79075274,1.067516199e-11,10186,1025432,252047880
426,2147601000,79038273,1.0670166855e-11,10186,1025432,253073312
427,2041683542,79038273,1.0670166855e-11,10186,1025432,254098744
428,2049470792,79038273,1.0670166855e-11,10186,1025432,255124176
429,2056396041,79075274,1.067516199e-11,10186,1025432,256149608
430,2064593792,79038273,1.0670166855e-11,10186,1025432,257175040
431,2053486417,79038271,1.0670166585e-11,10123,1025432,258200472
432,2058603583,79038271,1.0670166585e-11,10144,1025432,259225904
433,2050466000,79038271,1.0670166585e-11,10144,1025432,260251336
434,2049896958,79075273,1.0675161855000001e-11,10165,1025432,261276768
435,8567754208,79038272,1.067016672e-11,10165,1025432,262302200
436,2061371500,79075273,1.0675161855000001e-11,10165,1025432,263327632
437,2055147875,79038272,1.067016672e-11,10165,1025432,264353064
438,2050159250,79038273,1.0670166855e-11,10186,1025432,265378496
439,2061614083,79038273,1.0670166855e-11,10186,1025432,266403928
440,2053300958,79038667,1.0670220044999998e-11,23000,1025880,267429808
441,2060351834,79075275,1.0675162125e-11,10239,1025432,268455240
442,2055493667,79038275,1.0670167124999999e-11,10260,1025432,269480672
443,2051207125,79038275,1.0670167124999999e-11,10281,1025432,270506104
444,2072922875,79038275,1.0670167124999999e-11,10281,1025432,271531536
445,2032737167,79075276,1.0675162260000001e-11,10281,1025432,272556968
446,2181589916,79038276,1.067016726e-11,10302,1025432,273582400
447,2120809625,79038276,1.067016726e-11,10302,1025432,274607832
448,2827575417,79038276,1.067016726e-11,10302,1025432,275633264
449,15583103000,103058853,1.3912945155e-11,10302,-45687624,229945640
450,2053426542,79038273,1.0670166855e-11,10186,1025432,230971072
451,2052168500,79038271,1.0670166585e-11,10123,1025432,231996504
452,2056700792,79038271,1.0670166585e-11,10144,1025432,233021936
453,2101662916,79084592,1.067641992e-11,10144,1025432,234047368
454,2068262542,79038272,1.067016672e-11,10165,1025432,235072800
455,2126612333,79038272,1.067016672e-11,10165,1025432,236098232
456,2057645667,79038272,1.067016672e-11,10165,1025432,237123664
457,2049240417,79038662,1.0670219369999999e-11,22847,1025880,238149544
458,2053087875,79084594,1.0676420189999999e-11,10207,1025432,239174976
459,2052768875,79038274,1.067016699e-11,10228,1025432,240200408
460,2049588958,79038274,1.067016699e-11,10228,1025432,241225840
461,2050841917,79038271,1.0670166585e-11,10144,1025432,242251272
462,2062306333,79038272,1.067016672e-11,10165,1025432,243276704
463,2050553916,79084594,1.0676420189999999e-11,10186,1025432,244302136
464,2069371042,79038273,1.0670166855e-11,10186,1025432,245327568
465,2052577250,79038273,1.0670166855e-11,10186,1025432,246353000
466,2064359167,79038273,1.0670166855e-11,10186,1025432,247378432
467,2055553708,79038273,1.0670166855e-11,10207,1025432,248403864
468,2050706750,79084594,1.0676420189999999e-11,10207,1025432,249429296
469,2051876250,79038273,1.0670166855e-11,10207,1025432,250454728
470,2051662042,79038273,1.0670166855e-11,10207,1025432,251480160
471,2106180459,79038271,1.0670166585e-11,10144,1025432,252505592
472,2319414917,79084593,1.0676420055e-11,10165,1025432,253531024
473,2758585000,79038272,1.067016672e-11,10165,1025432,254556456
474,2911523000,79038658,1.067021883e-11,22715,1025880,255582336
475,3007715833,79038273,1.0670166855e-11,10207,1025432,256607768
476,2117926750,79084594,1.0676420189999999e-11,10207,1025432,257633200
477,2145965667,79038273,1.0670166855e-11,10207,1025432,258658632
478,21973900291,79038273,1.0670166855e-11,10207,1025432,259684064
479,4744739667,79154076,1.068580026e-11,10207,1025432,260709496
480,2069528083,79038273,1.0670166855e-11,10207,1025432,261734928
481,2054403709,79038271,1.0670166585e-11,10144,1025432,262760360
482,2052499833,79084593,1.0676420055e-11,10165,1025432,263785792
483,2051063125,79038272,1.067016672e-11,10165,1025432,264811224
484,2061445750,79038273,1.0670166855e-11,10186,1025432,265836656
485,2058781792,79038273,1.0670166855e-11,10186,1025432,266862088
486,2063400500,79038273,1.0670166855e-11,10186,1025432,267887520
487,2052643333,79084597,1.0676420594999999e-11,10302,1025432,268912952
488,2055796000,79038277,1.0670167395e-11,10323,1025432,269938384
489,2058705125,79038277,1.0670167395e-11,10323,1025432,270963816
490,2058789458,79038277,1.0670167395e-11,10323,1025432,271989248
491,2062901458,79084977,1.0676471895000001e-11,22657,1025880,273015128
492,2052832334,79038275,1.0670167124999999e-11,10281,1025432,274040560
493,2053330208,79038276,1.067016726e-11,10302,1025432,275065992
494,2208967667,79038276,1.067016726e-11,10302,1025432,276091424
495,2097106834,79038277,1.0670167395e-11,10323,1025432,277116856
496,3421192750,79084598,1.0676420730000001e-11,10323,1025432,278142288
497,3180258125,79038277,1.0670167395e-11,10323,1025432,279167720
498,2333155667,79038277,1.0670167395e-11,10323,1025432,280193152
499,2053711084,79084598,1.0676420730000001e-11,10323,1025432,281218584
500,2082762583,79038277,1.0670167395e-11,10323,1025432,282244016
501,2053267000,79038271,1.0670166585e-11,10134,1025432,283269448
502,2055318709,79038272,1.067016672e-11,10176,1025432,284294880
503,2055926666,79038272,1.067016672e-11,10176,1025432,285320312
504,2049789917,79084594,1.0676420189999999e-11,10218,1025432,286345744
505,2048638917,79038273,1.0670166855e-11,10218,1025432,287371176
506,2049929208,79038273,1.0670166855e-11,10218,1025432,288396608
507,2083737625,79038273,1.0670166855e-11,10218,1025432,289422040
508,2054676208,79038652,1.067021802e-11,22504,1025880,290447920
509,2123569792,79084597,1.0676420594999999e-11,10302,1025432,291473352
510,2059046041,79038276,1.067016726e-11,10302,1025432,292498784
511,2050706459,79038273,1.0670166855e-11,10218,1025432,293524216
512,8560490875,79089227,1.0677045645e-11,10239,1025432,294549648
513,2048498458,79038275,1.0670167124999999e-11,10260,1025432,295575080
514,2051632000,79038275,1.0670167124999999e-11,10260,1025432,296600512
515,2050467333,79038275,1.0670167124999999e-11,10260,1025432,297625944
516,2380227375,79084596,1.0676420459999999e-11,10281,1025432,298651376
517,2518494125,79038275,1.0670167124999999e-11,10281,1025432,299676808
518,2720177458,79038275,1.0670167124999999e-11,10281,1025432,300702240
519,3457779000,79084596,1.0676420459999999e-11,10281,1025432,301727672
520,2118278292,79038275,1.0670167124999999e-11,10281,1025432,302753104
521,2058542791,79038273,1.0670166855e-11,10218,1025432,303778536
522,2069559834,79038274,1.067016699e-11,10239,1025432,304803968
523,2145682500,79038274,1.067016699e-11,10239,1025432,305829400
524,2101387917,79084596,1.0676420459999999e-11,10260,1025432,306854832
525,2124934542,79038649,1.0670217615000001e-11,22414,1025880,307880712
526,2064327958,79038276,1.067016726e-11,10302,1025432,308906144
527,2050690708,79038276,1.067016726e-11,10302,1025432,309931576
528,2069054375,79084597,1.0676420594999999e-11,10302,1025432,310957008
529,2047040042,79038276,1.067016726e-11,10302,1025432,311982440
530,2076930209,79038276,1.067016726e-11,10302,1025432,313007872
531,2058700125,79038274,1.067016699e-11,10239,1025432,314033304
532,2090888583,79038275,1.0670167124999999e-11,10260,1025432,315058736
533,2074172459,79084596,1.0676420459999999e-11,10281,1025432,316084168
534,2072710333,79038275,1.0670167124999999e-11,10281,1025432,317109600
535,2061962333,79038275,1.0670167124999999e-11,10281,1025432,318135032
536,2089723083,79038275,1.0670167124999999e-11,10281,1025432,319160464
537,2065143083,79038276,1.067016726e-11,10302,1025432,320185896
538,2098709083,79084597,1.0676420594999999e-11,10302,1025432,321211328
539,2073461458,79038276,1.067016726e-11,10302,1025432,322236760
540,2298060167,79038276,1.067016726e-11,10302,1025432,323262192
541,4480248875,79038274,1.067016699e-11,10239,1025432,324287624
542,3370640250,79084965,1.0676470275e-11,22261,1025880,325313504
543,3359251666,79038290,1.067016915e-11,10765,1025432,326338936
544,2148897042,79038290,1.067016915e-11,10765,1025432,327364368
545,2035458042,79084612,1.067642262e-11,10786,1025432,328389800
546,2032540125,79038291,1.0670169285e-11,10786,1025432,329415232
547,2101811208,79038291,1.0670169285e-11,10786,1025432,330440664
548,2076258875,79038291,1.0670169285e-11,10786,1025432,331466096
549,2058564209,79084612,1.067642262e-11,10786,1025432,332491528
550,2095714375,79038291,1.0670169285e-11,10786,1025432,333516960
551,2071272958,79038289,1.0670169015e-11,10723,1025432,334542392
552,2074631166,79038290,1.067016915e-11,10744,1025432,335567824
553,2058196708,79038290,1.067016915e-11,10744,1025432,336593256
554,2092906625,79084611,1.0676422484999999e-11,10765,1025432,337618688
555,2055778000,79038290,1.067016915e-11,10765,1025432,338644120
556,2106735166,79038290,1.067016915e-11,10765,1025432,339669552
557,2067606500,79038290,1.067016915e-11,10765,1025432,340694984
558,2149718291,79038291,1.0670169285e-11,10786,1025432,341720416
559,2189517917,79085972,1.067660622e-11,54989,1027060,342747476
560,2080576583,79038307,1.0670171445000001e-11,11297,1025456,343772932
561,2405064625,79038304,1.0670171040000001e-11,11213,1025456,344798388
562,3428042125,79038305,1.0670171174999998e-11,11234,1025456,345823844
563,15320395708,109093973,1.4727686355e-11,11255,-57495008,288328836
564,2049338917,79107929,1.0679570415000001e-11,11255,1025456,289354292
565,2049529250,79038305,1.0670171174999998e-11,11255,1025456,290379748
566,2049742167,79038306,1.067017131e-11,11276,1025456,291405204
567,2055387458,79038306,1.067017131e-11,11276,1025456,292430660
568,2056453208,79096326,1.067800401e-11,11276,1025456,293456116
569,2050529708,79038306,1.067017131e-11,11276,1025456,294481572
570,2051721042,79038306,1.067017131e-11,11276,1025456,295507028
571,2050790167,79038304,1.0670171040000001e-11,11213,1025456,296532484
572,2059533458,79038305,1.0670171174999998e-11,11234,1025456,297557940
573,2049662375,79038305,1.0670171174999998e-11,11234,1025456,298583396
574,2062066833,79038305,1.0670171174999998e-11,11255,1025456,299608852
575,2058624542,79038305,1.0670171174999998e-11,11255,1025456,300634308
576,2126558625,79038736,1.067022936e-11,25257,1025904,301660212
577,2050503584,79096327,1.0678004144999999e-11,11297,1025456,302685668
578,2049168917,79038307,1.0670171445000001e-11,11297,1025456,303711124
579,2053688958,79038307,1.0670171445000001e-11,11297,1025456,304736580
580,2051200458,79038307,1.0670171445000001e-11,11318,1025456,305762036
581,2050894708,79038305,1.0670171174999998e-11,11234,1025456,306787492
582,2050758292,79096325,1.0678003875e-11,11255,1025456,307812948
583,2050363750,79038306,1.067017131e-11,11276,1025456,308838404
584,2056450709,79038306,1.067017131e-11,11276,1025456,309863860
585,2300227000,79038306,1.067017131e-11,11276,1025456,310889316
586,2729983167,79038306,1.067017131e-11,11276,1025456,311914772
587,4285921500,79038307,1.0670171445000001e-11,11297,1025456,312940228
588,2420504417,79038307,1.0670171445000001e-11,11297,1025456,313965684
589,2050378958,79038307,1.0670171445000001e-11,11297,1025456,314991140
590,2049983917,79096327,1.0678004144999999e-11,11297,1025456,316016596
591,2132214459,79038305,1.0670171174999998e-11,11234,1025456,317042052
592,2058388000,79038305,1.0670171174999998e-11,11255,1025456,318067508
593,2054862125,79038732,1.067022882e-11,25125,1025904,319093412
594,2050644959,79096326,1.067800401e-11,11276,1025456,320118868
595,2056864583,79038307,1.0670171445000001e-11,11297,1025456,321144324
596,2051216708,79038307,1.0670171445000001e-11,11297,1025456,322169780
597,2051443583,79038307,1.0670171445000001e-11,11297,1025456,323195236
598,2055219292,79038307,1.0670171445000001e-11,11297,1025456,324220692
599,11063432084,79102129,1.0678787415000001e-11,11297,1025456,325246148
600,2053701417,79038307,1.0670171445000001e-11,11297,1025456,326271604
601,2053991084,79096320,1.06780032e-11,11087,1025456,327297060
602,2050839084,79038301,1.0670170635e-11,11129,1025456,328322516
603,33368190459,79235569,1.0696801814999999e-11,11129,1025456,329347972
604,2061089667,79038303,1.0670170904999999e-11,11171,1025456,330373428
605,2065635542,79038303,1.0670170904999999e-11,11171,1025456,331398884
606,2065925291,79038303,1.0670170904999999e-11,11171,1025456,332424340
607,2047910416,79096323,1.0678003605e-11,11171,1025456,333449796
608,2080956375,79038304,1.0670171040000001e-11,11213,1025456,334475252
609,2561275791,79038304,1.0670171040000001e-11,11213,1025456,335500708
610,3594784166,79038727,1.0670228144999998e-11,24951,1025904,336526612
611,2379723375,79096323,1.0678003605e-11,11171,1025456,337552068
612,2327164417,79038303,1.0670170904999999e-11,11192,1025456,338577524
613,2051917917,79038304,1.0670171040000001e-11,11213,1025456,339602980
614,2053124292,79038304,1.0670171040000001e-11,11213,1025456,340628436
615,2055293083,79096324,1.067800374e-11,11213,1025456,341653892
616,2050569458,79038305,1.0670171174999998e-11,11234,1025456,342679348
617,2049069583,79038305,1.0670171174999998e-11,11234,1025456,343704804
618,2050243042,79038305,1.0670171174999998e-11,11234,1025456,344730260
619,2121523709,79096325,1.0678003875e-11,11234,1025456,345755716
620,2052320375,79038305,1.0670171174999998e-11,11234,1025456,346781172
621,2052024792,79038303,1.0670170904999999e-11,11171,1025456,347806628
622,2049616625,79038303,1.0670170904999999e-11,11192,1025456,348832084
623,2053300667,79038303,1.0670170904999999e-11,11192,1025456,349857540
624,2050667750,79096324,1.067800374e-11,11213,1025456,350882996
625,2051317959,79038304,1.0670171040000001e-11,11213,1025456,351908452
626,2051722709,79038304,1.0670171040000001e-11,11213,1025456,352933908
627,2052051208,79038723,1.0670227604999999e-11,24819,1025904,353959812
628,2037828166,79038305,1.0670171174999998e-11,11255,1025456,354985268
629,2124611084,79096326,1.067800401e-11,11276,1025456,356010724
630,2058082000,79038306,1.067017131e-11,11276,1025456,357036180
631,2047930333,79038303,1.0670170904999999e-11,11192,1025456,358061636
632,2049246083,79038304,1.0670171040000001e-11,11213,1025456,359087092
633,2050151000,79038305,1.0670171174999998e-11,11234,1025456,360112548
634,2062091792,79038305,1.0670171174999998e-11,11234,1025456,361138004
635,2104426708,79096325,1.0678003875e-11,11234,1025456,362163460
636,2057806833,79038305,1.0670171174999998e-11,11234,1025456,363188916
637,2134909084,79038305,1.0670171174999998e-11,11255,1025456,364214372
638,3741089208,79096325,1.0678003875e-11,11255,1025456,365239828
639,4658047334,79038305,1.0670171174999998e-11,11255,1025456,366265284
640,2322574667,79038305,1.0670171174999998e-11,11255,1025456,367290740
641,3077180458,79096323,1.0678003605e-11,11192,1025456,368316196
642,2116278041,79038304,1.0670171040000001e-11,11213,1025456,369341652
643,2062636250,79038304,1.0670171040000001e-11,11213,1025456,370367108
644,2143139917,79038719,1.0670227065e-11,24687,1025904,371393012
645,2053064541,79096326,1.067800401e-11,11276,1025456,372418468
646,2051762708,79038306,1.067017131e-11,11276,1025456,373443924
647,2049384291,79038306,1.067017131e-11,11276,1025456,374469380
648,2055998708,79038306,1.067017131e-11,11276,1025456,375494836
649,2052857125,79038306,1.067017131e-11,11276,1025456,376520292
650,2082566042,79096326,1.067800401e-11,11276,1025456,377545748
651,2070693792,79038304,1.0670171040000001e-11,11213,1025456,378571204
652,2047680958,79038305,1.0670171174999998e-11,11234,1025456,379596660
653,2061550083,79038305,1.0670171174999998e-11,11234,1025456,380622116
654,2130391584,79096325,1.0678003875e-11,11255,1025456,381647572
655,2095538750,79038305,1.0670171174999998e-11,11255,1025456,382673028
656,2056526250,79038305,1.0670171174999998e-11,11255,1025456,383698484
657,2088245875,79038305,1.0670171174999998e-11,11255,1025456,384723940
658,2059083916,79038306,1.067017131e-11,11276,1025456,385749396
659,2089852959,79038306,1.067017131e-11,11276,1025456,386774852
660,2060774166,79096326,1.067800401e-11,11276,1025456,387800308
661,2094228958,79038714,1.067022639e-11,24534,1025904,388826212
662,2047811334,79038305,1.0670171174999998e-11,11234,1025456,389851668
663,2086929875,79038305,1.0670171174999998e-11,11255,1025456,390877124
664,2154567083,79096325,1.0678003875e-11,11255,1025456,391902580
665,2054015125,79038306,1.067017131e-11,11276,1025456,392928036
666,2056846333,79038306,1.067017131e-11,11276,1025456,393953492
667,2091784333,79038306,1.067017131e-11,11276,1025456,394978948
668,2222443750,79038306,1.067017131e-11,11276,1025456,396004404
669,2383872292,79096326,1.067800401e-11,11276,1025456,397029860
670,2676469458,79038306,1.067017131e-11,11276,1025456,398055316
671,3762665750,79038304,1.0670171040000001e-11,11213,1025456,399080772
672,3572479666,79096325,1.0678003875e-11,11234,1025456,400106228
673,2054074750,79038305,1.0670171174999998e-11,11234,1025456,401131684
674,2060171667,79038305,1.0670171174999998e-11,11255,1025456,402157140
675,2103649500,79096325,1.0678003875e-11,11255,1025456,403182596
676,2056826667,79038305,1.0670171174999998e-11,11255,1025456,404208052
677,2148702375,79038305,1.0670171174999998e-11,11255,1025456,405233508
678,2084363416,79038712,1.067022612e-11,24465,1025904,406259412
679,2056360750,79038307,1.0670171445000001e-11,11297,1025456,407284868
680,2088694167,79096327,1.0678004144999999e-11,11297,1025456,408310324
681,2056143875,79038304,1.0670171040000001e-11,11213,1025456,409335780
682,2089862333,79038305,1.0670171174999998e-11,11234,1025456,410361236
683,2081562167,79038305,1.0670171174999998e-11,11255,1025456,411386692
684,2071416084,79038305,1.0670171174999998e-11,11255,1025456,412412148
685,2056877708,79096325,1.0678003875e-11,11255,1025456,413437604
686,2086135833,79038306,1.067017131e-11,11276,1025456,414463060
687,2058696917,79038306,1.067017131e-11,11276,1025456,415488516
688,2121065000,79038306,1.067017131e-11,11276,1025456,416513972
689,2059875583,79038306,1.067017131e-11,11276,1025456,417539428
690,2091458125,79096326,1.067800401e-11,11276,1025456,418564884
691,2055185958,79038304,1.0670171040000001e-11,11213,1025456,419590340
692,2088502541,79038305,1.0670171174999998e-11,11234,1025456,420615796
693,2060101250,79038305,1.0670171174999998e-11,11234,1025456,421641252
694,2093230291,79038305,1.0670171174999998e-11,11255,1025456,422666708
695,2059225541,79096728,1.067805828e-11,24333,1025904,423692612
696,2085808292,79038306,1.067017131e-11,11276,1025456,424718068
697,2063995625,79038306,1.067017131e-11,11276,1025456,425743524
698,2085629667,79038306,1.067017131e-11,11276,1025456,426768980
699,2073812250,79038306,1.067017131e-11,11276,1025456,427794436
700,2084597875,79096326,1.067800401e-11,11276,1025456,428819892
701,14151190500,79096320,1.06780032e-11,11087,1025456,429845348
702,3305529500,79038301,1.0670170635e-11,11129,1025456,430870804
703,3270622042,79096323,1.0678003605e-11,11171,1025456,431896260
704,2049523708,79038303,1.0670170904999999e-11,11171,1025456,432921716
705,17670065625,116674323,1.5751033605e-11,11171,-71870904,361050812
706,2050187000,79110866,1.0679966909999999e-11,11171,1025456,362076268
707,3265050208,79038304,1.0670171040000001e-11,11213,1025456,363101724
708,2048773334,79038304,1.0670171040000001e-11,11213,1025456,364127180
709,3267216416,79038304,1.0670171040000001e-11,11213,1025456,365152636
710,2048685458,79110867,1.0679967045e-11,11213,1025456,366178092
711,3312770375,79038302,1.0670170770000001e-11,11150,1025456,367203548
712,2049182916,79038701,1.0670224635e-11,24096,1025904,368229452
713,2133264250,79038304,1.0670171040000001e-11,11213,1025456,369254908
714,3266485250,79110867,1.0679967045e-11,11213,1025456,370280364
715,2057867291,79038305,1.0670171174999998e-11,11234,1025456,371305820
716,3268265250,79038305,1.0670171174999998e-11,11234,1025456,372331276
717,3314277708,79110868,1.067996718e-11,11234,1025456,373356732
718,3263588083,79038305,1.0670171174999998e-11,11234,1025456,374382188
719,2070206916,79038305,1.0670171174999998e-11,11234,1025456,375407644
720,3277900958,79038305,1.0670171174999998e-11,11234,1025456,376433100
721,2112367709,79110866,1.0679966909999999e-11,11171,1025456,377458556
722,3319828250,79038303,1.0670170904999999e-11,11192,1025456,378484012
723,3337180625,79038303,1.0670170904999999e-11,11192,1025456,379509468
724,3320040458,79110867,1.0679967045e-11,11213,1025456,380534924
725,3342564333,79038304,1.0670171040000001e-11,11213,1025456,381560380
726,3267515833,79038304,1.0670171040000001e-11,11213,1025456,382585836
727,3265140875,79038304,1.0670171040000001e-11,11213,1025456,383611292
728,2062799417,79110868,1.067996718e-11,11234,1025456,384636748
729,2294845417,79038699,1.0670224365e-11,24048,1025904,385662652
730,2914950125,79038306,1.067017131e-11,11276,1025456,386688108
731,2284104208,79110866,1.0679966909999999e-11,11192,1025456,387713564
732,3389512542,79038304,1.0670171040000001e-11,11213,1025456,388739020
733,2617121334,79038305,1.0670171174999998e-11,11234,1025456,389764476
734,2052951042,79110868,1.067996718e-11,11234,1025456,390789932
735,2046808917,79038305,1.0670171174999998e-11,11234,1025456,391815388
736,2126373375,79038305,1.0670171174999998e-11,11255,1025456,392840844
737,2077857959,79038305,1.0670171174999998e-11,11255,1025456,393866300
738,2070866750,79038305,1.0670171174999998e-11,11255,1025456,394891756
739,2050002500,79110868,1.067996718e-11,11255,1025456,395917212
740,2048184583,79038305,1.0670171174999998e-11,11255,1025456,396942668
741,2071129958,79038303,1.0670170904999999e-11,11192,1025456,397968124
742,2050635875,79038304,1.0670171040000001e-11,11213,1025456,398993580
743,2052336458,79038304,1.0670171040000001e-11,11213,1025456,400019036
744,2062097666,79110868,1.067996718e-11,11234,1025456,401044492
745,2054203208,79038305,1.0670171174999998e-11,11234,1025456,402069948
746,2055440500,79038695,1.0670223825e-11,23916,1025904,403095852
747,2060299500,79038305,1.0670171174999998e-11,11255,1025456,404121308
748,2055630916,79038305,1.0670171174999998e-11,11255,1025456,405146764
749,2054610250,79110868,1.067996718e-11,11255,1025456,406172220
750,2487039958,79038306,1.067017131e-11,11276,1025456,407197676
751,4073064250,79038303,1.0670170904999999e-11,11192,1025456,408223132
752,2540943917,79110867,1.0679967045e-11,11213,1025456,409248588
753,3442650708,79038305,1.0670171174999998e-11,11234,1025456,410274044
754,2056340459,79038305,1.0670171174999998e-11,11234,1025456,411299500
755,2062852750,79038305,1.0670171174999998e-11,11234,1025456,412324956
756,2050146875,79110868,1.067996718e-11,11234,1025456,413350412
757,2061400416,79038305,1.0670171174999998e-11,11255,1025456,414375868
758,2049201917,79038305,1.0670171174999998e-11,11255,1025456,415401324
759,2057095500,79038305,1.0670171174999998e-11,11255,1025456,416426780
760,2043970958,79038305,1.0670171174999998e-11,11255,1025456,417452236
761,2071246875,79110866,1.0679966909999999e-11,11192,1025456,418477692
762,2051479125,79038304,1.0670171040000001e-11,11213,1025456,419503148
763,2052013500,79038690,1.067022315e-11,23763,1025904,420529052
764,2049856042,79038305,1.0670171174999998e-11,11255,1025456,421554508
765,2048895959,79038306,1.067017131e-11,11276,1025456,422579964
766,2054277250,79110869,1.0679967314999999e-11,11276,1025456,423605420
767,2043688000,79038306,1.067017131e-11,11276,1025456,424630876
768,2050597667,79038306,1.067017131e-11,11276,1025456,425656332
769,2052301959,79038306,1.067017131e-11,11276,1025456,426681788
770,2050966792,79038306,1.067017131e-11,11276,1025456,427707244
771,2048011958,79110867,1.0679967045e-11,11213,1025456,428732700
772,2078624625,79038305,1.0670171174999998e-11,11234,1025456,429758156
773,2057876667,79038305,1.0670171174999998e-11,11234,1025456,430783612
774,2053051417,79038305,1.0670171174999998e-11,11255,1025456,431809068
775,2178492042,79038305,1.0670171174999998e-11,11255,1025456,432834524
776,2356400042,79110868,1.067996718e-11,11255,1025456,433859980
777,2172888834,79038305,1.0670171174999998e-11,11255,1025456,434885436
778,2388420083,79038306,1.067017131e-11,11276,1025456,435910892
779,2214105542,79038306,1.067017131e-11,11276,1025456,436936348
780,2183659250,79111251,1.0680018884999999e-11,23694,1025904,437962252
781,2060647292,79038304,1.0670171040000001e-11,11213,1025456,438987708
782,2068000333,79038305,1.0670171174999998e-11,11234,1025456,440013164
783,2120201916,79038305,1.0670171174999998e-11,11255,1025456,441038620
784,2059200166,79110868,1.067996718e-11,11255,1025456,442064076
785,2114383083,79038305,1.0670171174999998e-11,11255,1025456,443089532
786,2061764917,79038306,1.067017131e-11,11276,1025456,444114988
787,2093021000,79038306,1.067017131e-11,11276,1025456,445140444
788,2072826042,79038306,1.067017131e-11,11276,1025456,446165900
789,2099329750,79110869,1.0679967314999999e-11,11276,1025456,447191356
790,2082487708,79038306,1.067017131e-11,11276,1025456,448216812
791,2085649125,79038304,1.0670171040000001e-11,11213,1025456,449242268
792,2058622666,79038305,1.0670171174999998e-11,11234,1025456,450267724
793,2107602250,79038305,1.0670171174999998e-11,11234,1025456,451293180
794,2374628708,79110868,1.067996718e-11,11255,1025456,452318636
795,2436754084,79038305,1.0670171174999998e-11,11255,1025456,453344092
796,4262725042,79038305,1.0670171174999998e-11,11255,1025456,454369548
797,2480572791,79111246,1.068001821e-11,23541,1025904,455395452
798,2363973459,79038306,1.067017131e-11,11276,1025456,456420908
799,2058155958,79038307,1.0670171445000001e-11,11297,1025456,457446364
800,2059650708,79038307,1.0670171445000001e-11,11297,1025456,458471820
801,2067247667,79110863,1.0679966505e-11,11087,1025456,459497276
802,2064849167,79038301,1.0670170635e-11,11129,1025456,460522732
803,2058797875,79038303,1.0670170904999999e-11,11171,1025456,461548188
804,2060989125,79038303,1.0670170904999999e-11,11171,1025456,462573644
805,2059568084,79038303,1.0670170904999999e-11,11171,1025456,463599100
806,2057065083,79110866,1.0679966909999999e-11,11171,1025456,464624556
807,2049613500,79038304,1.0670171040000001e-11,11213,1025456,465650012
808,2070458709,79038304,1.0670171040000001e-11,11213,1025456,466675468
809,2054174084,79038304,1.0670171040000001e-11,11213,1025456,467700924
810,2142102250,79110867,1.0679967045e-11,11213,1025456,468726380
811,2065068708,79038302,1.0670170770000001e-11,11150,1025456,469751836
812,2079837959,79038303,1.0670170904999999e-11,11171,1025456,470777292
813,2052279459,79038303,1.0670170904999999e-11,11171,1025456,471802748
814,2309453291,79038677,1.0670221394999999e-11,23325,1025904,472828652
815,2398534625,79110868,1.067996718e-11,11234,1025456,473854108
816,2878565208,79038305,1.0670171174999998e-11,11234,1025456,474879564
817,2396732916,79038305,1.0670171174999998e-11,11234,1025456,475905020
818,3102166500,79038305,1.0670171174999998e-11,11234,1025456,476930476
819,2528262208,79110868,1.067996718e-11,11234,1025456,477955932
820,2051612542,79038305,1.0670171174999998e-11,11234,1025456,478981388
821,2071402208,79038303,1.0670170904999999e-11,11171,1025456,480006844
822,2050990667,79038303,1.0670170904999999e-11,11192,1025456,481032300
823,14065767917,79197941,1.0691722035000002e-11,11192,1025456,482057756
824,2050853208,79038304,1.0670171040000001e-11,11213,1025456,483083212
825,2065411750,79038304,1.0670171040000001e-11,11213,1025456,484108668
826,2055966792,79038304,1.0670171040000001e-11,11213,1025456,485134124
827,2111977208,79038304,1.0670171040000001e-11,11213,1025456,486159580
828,2068197250,79110868,1.067996718e-11,11234,1025456,487185036
829,2085588875,79038305,1.0670171174999998e-11,11234,1025456,488210492
830,2058791125,79038305,1.0670171174999998e-11,11234,1025456,489235948
831,2091428958,79038672,1.067022072e-11,23172,1025904,490261852
832,2068505833,79038318,1.0670172929999999e-11,11676,1025456,491287308
833,2100820375,79110882,1.067996907e-11,11697,1025456,492312764
834,2316459000,79038319,1.0670173065e-11,11697,1025456,493338220
835,2986942750,79038320,1.0670173200000002e-11,11718,1025456,494363676
836,3979705083,79110883,1.0679969205e-11,11718,1025456,495389132
837,2497351292,79038320,1.0670173200000002e-11,11718,1025456,496414588
838,2502741625,79038320,1.0670173200000002e-11,11718,1025456,497440044
839,2049882750,79038320,1.0670173200000002e-11,11718,1025456,498465500
840,2054060583,79110883,1.0679969205e-11,11718,1025456,499490956
841,2050866167,79038318,1.0670172929999999e-11,11655,1025456,500516412
842,2052847833,79038318,1.0670172929999999e-11,11676,1025456,501541868
843,2071203625,79038318,1.0670172929999999e-11,11676,1025456,502567324
844,2070582125,79038319,1.0670173065e-11,11697,1025456,503592780
845,2087224334,79110882,1.067996907e-11,11697,1025456,504618236
846,2059692334,79038319,1.0670173065e-11,11697,1025456,505643692
847,2090645917,79038319,1.0670173065e-11,11697,1025456,506669148
848,2091025167,79039572,1.067034222e-11,52423,1026708,507695856
849,2088524750,79038307,1.0670171445000001e-11,11297,1025456,508721312
850,2064887708,79110870,1.067996745e-11,11297,1025456,509746768
851,2120571916,79038304,1.0670171040000001e-11,11213,1025456,510772224
852,2046107458,79038305,1.0670171174999998e-11,11234,1025456,511797680
853,2131870708,79038305,1.0670171174999998e-11,11255,1025456,512823136
854,2301642959,79110868,1.067996718e-11,11255,1025456,513848592
855,3265172667,79038305,1.0670171174999998e-11,11255,1025456,514874048
856,2399533125,79038306,1.067017131e-11,11276,1025456,515899504
857,2686537208,79038306,1.067017131e-11,11276,1025456,516924960
858,2747099666,79110869,1.0679967314999999e-11,11276,1025456,517950416
859,2049657209,79038306,1.067017131e-11,11276,1025456,518975872
860,2063211875,79038306,1.067017131e-11,11276,1025456,520001328
861,2055889667,79038304,1.0670171040000001e-11,11213,1025456,521026784
862,2053581625,79110868,1.067996718e-11,11234,1025456,522052240
863,2050509125,79038305,1.0670171174999998e-11,11234,1025456,523077696
864,2050901500,79038305,1.0670171174999998e-11,11255,1025456,524103152
865,2055172750,79038736,1.067022936e-11,25257,1025904,525129056
866,2049843541,79038306,1.067017131e-11,11276,1025456,526154512
867,2049112250,79110869,1.0679967314999999e-11,11276,1025456,527179968
868,2050962041,79038306,1.067017131e-11,11276,1025456,528205424
869,2051705833,79038306,1.067017131e-11,11276,1025456,529230880
870,2049247209,79038306,1.067017131e-11,11276,1025456,530256336
871,2052953208,79038304,1.0670171040000001e-11,11213,1025456,531281792
872,2051601417,79110868,1.067996718e-11,11234,1025456,532307248
873,2064335959,79038305,1.0670171174999998e-11,11255,1025456,533332704
874,2060794750,79038305,1.0670171174999998e-11,11255,1025456,534358160
875,2095423041,79038305,1.0670171174999998e-11,11255,1025456,535383616
876,2068148542,79038305,1.0670171174999998e-11,11255,1025456,536409072
877,2124160958,79110869,1.0679967314999999e-11,11276,1025456,537434528
878,2069756083,79038306,1.067017131e-11,11276,1025456,538459984
879,2057874041,79038306,1.067017131e-11,11276,1025456,539485440
880,2063992375,79038306,1.067017131e-11,11276,1025456,540510896
881,2496439708,79110867,1.0679967045e-11,11213,1025456,541536352
882,4707905250,79038731,1.0670228685e-11,25083,1025904,542562256
883,22535824625,126294847,1.7049804345e-11,11276,-90352400,452209856
884,2063271708,79038306,1.067017131e-11,11276,1025456,453235312
885,2050844250,79038307,1.0670171445000001e-11,11297,1025456,454260768
886,2060775209,79129139,1.0682433765e-11,11297,1025456,455286224
887,2075170500,79038307,1.0670171445000001e-11,11297,1025456,456311680
888,2063783958,79038307,1.0670171445000001e-11,11297,1025456,457337136
889,2059676083,79038307,1.0670171445000001e-11,11297,1025456,458362592
890,2048559542,79038307,1.0670171445000001e-11,11297,1025456,459388048
891,2048580584,79129137,1.0682433495e-11,11234,1025456,460413504
892,2054015750,79038305,1.0670171174999998e-11,11255,1025456,461438960
893,2062003625,79038305,1.0670171174999998e-11,11255,1025456,462464416
894,2051009750,79038306,1.067017131e-11,11276,1025456,463489872
895,2065460750,79129138,1.068243363e-11,11276,1025456,464515328
896,2050873291,79038306,1.067017131e-11,11276,1025456,465540784
897,2062942833,79038306,1.067017131e-11,11276,1025456,466566240
898,2063022833,79038307,1.0670171445000001e-11,11297,1025456,467591696
899,2055155833,79038729,1.0670228415000001e-11,25035,1025904,468617600
900,2299657958,79129139,1.0682433765e-11,11318,1025456,469643056
901,2278862083,79038300,1.0670170499999999e-11,11087,1025456,470668512
902,2452355625,79038301,1.0670170635e-11,11129,1025456,471693968
903,2590354166,79038303,1.0670170904999999e-11,11171,1025456,472719424
904,2289111875,79129135,1.0682433225e-11,11171,1025456,473744880
905,2050444750,79038303,1.0670170904999999e-11,11171,1025456,474770336
906,2054138541,79038304,1.0670171040000001e-11,11213,1025456,475795792
907,2059802167,79038304,1.0670171040000001e-11,11213,1025456,476821248
908,2060064208,79038304,1.0670171040000001e-11,11213,1025456,477846704
909,2056448750,79129136,1.068243336e-11,11213,1025456,478872160
910,2060570292,79038304,1.0670171040000001e-11,11213,1025456,479897616
911,2049833458,79038302,1.0670170770000001e-11,11150,1025456,480923072
912,2051125125,79038303,1.0670170904999999e-11,11171,1025456,481948528
913,2049942208,79038303,1.0670170904999999e-11,11171,1025456,482973984
914,2049903834,79129135,1.0682433225e-11,11192,1025456,483999440
915,2049221875,79038303,1.0670170904999999e-11,11192,1025456,485024896
916,2049874250,79038722,1.0670227469999999e-11,24798,1025904,486050800
917,2050546625,79038305,1.0670171174999998e-11,11255,1025456,487076256
918,2048922333,79129137,1.0682433495e-11,11255,1025456,488101712
919,2049791167,79038305,1.0670171174999998e-11,11255,1025456,489127168
920,2057908750,79038306,1.067017131e-11,11276,1025456,490152624
921,2069747083,79038303,1.0670170904999999e-11,11192,1025456,491178080
922,2050518209,79038304,1.0670171040000001e-11,11213,1025456,492203536
923,2106105459,79129137,1.0682433495e-11,11234,1025456,493228992
924,2050934875,79038305,1.0670171174999998e-11,11234,1025456,494254448
925,2111292500,79038305,1.0670171174999998e-11,11234,1025456,495279904
926,2054405459,79038305,1.0670171174999998e-11,11234,1025456,496305360
927,2172817292,79038305,1.0670171174999998e-11,11255,1025456,497330816
928,2188605625,79129137,1.0682433495e-11,11255,1025456,498356272
929,2377634209,79038305,1.0670171174999998e-11,11255,1025456,499381728
930,2444765208,79038305,1.0670171174999998e-11,11255,1025456,500407184
931,2353399000,79038303,1.0670170904999999e-11,11192,1025456,501432640
932,2286137416,79129136,1.068243336e-11,11213,1025456,502458096
933,2051568250,79038719,1.0670227065e-11,24687,1025904,503484000
934,2056115292,79038305,1.0670171174999998e-11,11255,1025456,504509456
935,2072335625,79038306,1.067017131e-11,11276,1025456,505534912
936,2097770959,79038306,1.067017131e-11,11276,1025456,506560368
937,2057150084,79129138,1.068243363e-11,11276,1025456,507585824
938,2077276958,79038306,1.067017131e-11,11276,1025456,508611280
939,2054665041,79038306,1.067017131e-11,11276,1025456,509636736
940,2138843583,79038306,1.067017131e-11,11276,1025456,510662192
941,2051604041,79038304,1.0670171040000001e-11,11213,1025456,511687648
942,2114877000,79129137,1.0682433495e-11,11234,1025456,512713104
943,2049528834,79038305,1.0670171174999998e-11,11234,1025456,513738560
944,2096548084,79038305,1.0670171174999998e-11,11255,1025456,514764016
945,2060556292,79038305,1.0670171174999998e-11,11255,1025456,515789472
946,2130012500,79129137,1.0682433495e-11,11255,1025456,516814928
947,2275516250,79038305,1.0670171174999998e-11,11255,1025456,517840384
948,2775637916,79038306,1.067017131e-11,11276,1025456,518865840
949,2304147666,79038306,1.067017131e-11,11276,1025456,519891296
950,2221617583,79129549,1.0682489115e-11,24618,1025904,520917200
951,2415081292,79038304,1.0670171040000001e-11,11213,1025456,521942656
952,2326474333,79038305,1.0670171174999998e-11,11234,1025456,522968112
953,2049173042,79038305,1.0670171174999998e-11,11255,1025456,523993568
954,2048582750,79038305,1.0670171174999998e-11,11255,1025456,525019024
955,2051469541,79129137,1.0682433495e-11,11255,1025456,526044480
956,2059221708,79038306,1.067017131e-11,11276,1025456,527069936
957,2064993708,79038306,1.067017131e-11,11276,1025456,528095392
958,2055505250,79038306,1.067017131e-11,11276,1025456,529120848
959,2059626958,79129138,1.068243363e-11,11276,1025456,530146304
960,2050150625,79038306,1.067017131e-11,11276,1025456,531171760
961,2048683750,79038304,1.0670171040000001e-11,11213,1025456,532197216
962,2049224417,79038305,1.0670171174999998e-11,11234,1025456,533222672
963,2065949250,79038305,1.0670171174999998e-11,11234,1025456,534248128
964,2049770417,79129137,1.0682433495e-11,11255,1025456,535273584
965,2113933209,79038305,1.0670171174999998e-11,11255,1025456,536299040
966,17666462833,79147304,1.068488604e-11,11255,1025456,537324496
967,2121246916,79038712,1.067022612e-11,24465,1025904,538350400
968,2049911458,79129138,1.068243363e-11,11276,1025456,539375856
969,2104194792,79038307,1.0670171445000001e-11,11297,1025456,540401312
970,2050300042,79038307,1.0670171445000001e-11,11297,1025456,541426768
971,2169836958,79038304,1.0670171040000001e-11,11213,1025456,542452224
972,2053254917,79038305,1.0670171174999998e-11,11234,1025456,543477680
973,2648953958,79129137,1.0682433495e-11,11255,1025456,544503136
974,2319318000,79038305,1.0670171174999998e-11,11255,1025456,545528592
975,2813229750,79038305,1.0670171174999998e-11,11255,1025456,546554048
976,4133190583,79129137,1.0682433495e-11,11255,1025456,547579504
977,2786655125,79038306,1.067017131e-11,11276,1025456,548604960
978,2055311541,79038306,1.067017131e-11,11276,1025456,549630416
979,2069621000,79129138,1.068243363e-11,11276,1025456,550655872
980,2081692584,79038306,1.067017131e-11,11276,1025456,551681328
981,2110615250,79038304,1.0670171040000001e-11,11213,1025456,552706784
982,2064123458,79038305,1.0670171174999998e-11,11234,1025456,553732240
983,2115297083,79038305,1.0670171174999998e-11,11234,1025456,554757696
984,2043984292,79129539,1.0682487765e-11,24312,1025904,555783600
985,2094078584,79038306,1.067017131e-11,11276,1025456,556809056
986,2073855125,79038306,1.067017131e-11,11276,1025456,557834512
987,2113253375,79038306,1.067017131e-11,11276,1025456,558859968
988,2052626083,79038306,1.067017131e-11,11276,1025456,559885424
989,2116054834,79129138,1.068243363e-11,11276,1025456,560910880
990,2063256083,79038306,1.067017131e-11,11276,1025456,561936336
991,2083000291,79038304,1.0670171040000001e-11,11213,1025456,562961792
992,2352920500,79038305,1.0670171174999998e-11,11234,1025456,563987248
993,3248366291,79129137,1.0682433495e-11,11234,1025456,565012704
994,3818439459,79038305,1.0670171174999998e-11,11255,1025456,566038160
995,2746238583,79038305,1.0670171174999998e-11,11255,1025456,567063616
996,3717906667,79129137,1.0682433495e-11,11255,1025456,568089072
997,2055223333,79038305,1.0670171174999998e-11,11255,1025456,569114528
998,2059979792,79038306,1.067017131e-11,11276,1025456,570139984
999,2049126000,79038306,1.067017131e-11,11276,1025456,571165440
1000,2055038083,79129138,1.068243363e-11,11276,1025456,572190896
1001,2057013708,79038691,1.0670223285e-11,23781,1025904,573216800
1002,2082757166,79038296,1.067016996e-11,10961,1025456,574242256
1003,2087888667,79038298,1.0670170229999999e-11,11024,1025456,575267712
1004,2058654792,79038298,1.0670170229999999e-11,11024,1025456,576293168
1005,2120699834,79129132,1.068243282e-11,11087,1025456,577318624
1006,2072716083,79038300,1.0670170499999999e-11,11087,1025456,578344080
1007,2115099833,79038300,1.0670170499999999e-11,11087,1025456,579369536
1008,2050358042,79038300,1.0670170499999999e-11,11087,1025456,580394992
1009,2138569666,79038300,1.0670170499999999e-11,11087,1025456,581420448
1010,2058247542,79129132,1.068243282e-11,11087,1025456,582445904
1011,2106361167,79038298,1.0670170229999999e-11,11024,1025456,583471360
1012,2066503333,79038299,1.0670170365e-11,11045,1025456,584496816
1013,2224790834,79038299,1.0670170365e-11,11045,1025456,585522272
1014,2595867542,79129132,1.068243282e-11,11066,1025456,586547728
1015,3018538125,79038301,1.0670170635e-11,11108,1025456,587573184
1016,3850841292,79038301,1.0670170635e-11,11108,1025456,588598640
1017,2642608292,79129133,1.0682432955000001e-11,11108,1025456,589624096
1018,2401079125,79038695,1.0670223825e-11,23922,1025904,590650000
1019,2063295083,79038303,1.0670170904999999e-11,11192,1025456,591675456
1020,2050798542,79038303,1.0670170904999999e-11,11192,1025456,592700912
1021,2057307084,79129133,1.0682432955000001e-11,11108,1025456,593726368
1022,2049927333,79038301,1.0670170635e-11,11129,1025456,594751824
1023,2069025708,79038302,1.0670170770000001e-11,11150,1025456,595777280
1024,2129145958,79038302,1.0670170770000001e-11,11150,1025456,596802736
1025,2062844833,79038302,1.0670170770000001e-11,11150,1025456,597828192
1026,2129261750,79129135,1.0682433225e-11,11171,1025456,598853648
1027,2080620583,79038303,1.0670170904999999e-11,11171,1025456,599879104
1028,2073391417,79038303,1.0670170904999999e-11,11171,1025456,600904560
1029,2059740375,79038303,1.0670170904999999e-11,11171,1025456,601930016
1030,2113741416,79038303,1.0670170904999999e-11,11171,1025456,602955472
1031,2049850542,79129133,1.0682432955000001e-11,11108,1025456,603980928
1032,2152809375,79038301,1.0670170635e-11,11129,1025456,605006384
1033,2608739750,79038301,1.0670170635e-11,11129,1025456,606031840
1034,2418404250,79038302,1.0670170770000001e-11,11150,1025456,607057296
1035,3798068250,79129524,1.068248574e-11,23832,1025904,608083200
1036,2464412417,79038303,1.0670170904999999e-11,11171,1025456,609108656
1037,3409883375,79038303,1.0670170904999999e-11,11171,1025456,610134112
1038,2054126417,79129135,1.0682433225e-11,11171,1025456,611159568
1039,2056497750,79038303,1.0670170904999999e-11,11171,1025456,612185024
1040,2123419292,79038303,1.0670170904999999e-11,11171,1025456,613210480
1041,2064141625,79038301,1.0670170635e-11,11108,1025456,614235936
1042,2056087167,79129133,1.0682432955000001e-11,11129,1025456,615261392
1043,2069417208,79038302,1.0670170770000001e-11,11150,1025456,616286848
1044,2061128458,79038302,1.0670170770000001e-11,11150,1025456,617312304
1045,2066632417,79038302,1.0670170770000001e-11,11150,1025456,618337760
1046,2049804500,79038302,1.0670170770000001e-11,11150,1025456,619363216
1047,2056314375,79129135,1.0682433225e-11,11171,1025456,620388672
1048,2050309709,79038303,1.0670170904999999e-11,11171,1025456,621414128
1049,2063761750,79038303,1.0670170904999999e-11,11171,1025456,622439584
1050,2051364000,79038303,1.0670170904999999e-11,11171,1025456,623465040
1051,2067417917,79038301,1.0670170635e-11,11108,1025456,624490496
1052,2063423667,79129519,1.0682485065e-11,23658,1025904,625516400
1053,2129590167,79038303,1.0670170904999999e-11,11192,1025456,626541856
1054,3017713167,79038303,1.0670170904999999e-11,11192,1025456,627567312
1055,3777621625,79129136,1.068243336e-11,11213,1025456,628592768
1056,3597984625,79038304,1.0670171040000001e-11,11213,1025456,629618224
1057,2810278000,79038304,1.0670171040000001e-11,11213,1025456,630643680
1058,2052590584,79038304,1.0670171040000001e-11,11213,1025456,631669136
1059,2050028667,79129136,1.068243336e-11,11213,1025456,632694592
1060,2084540083,79038304,1.0670171040000001e-11,11213,1025456,633720048
1061,2055079833,79038302,1.0670170770000001e-11,11150,1025456,634745504
1062,2050079208,79038303,1.0670170904999999e-11,11171,1025456,635770960
1063,2050273125,79038303,1.0670170904999999e-11,11171,1025456,636796416
1064,2049930125,79129135,1.0682433225e-11,11192,1025456,637821872
1065,2050072833,79038303,1.0670170904999999e-11,11192,1025456,638847328
1066,2049736459,79038303,1.0670170904999999e-11,11192,1025456,639872784
1067,2085042417,79038303,1.0670170904999999e-11,11192,1025456,640898240
1068,2059678125,79038304,1.0670171040000001e-11,11213,1025456,641923696
1069,2118709541,79129518,1.068248493e-11,23631,1025904,642949600
1070,2051408292,79038305,1.0670171174999998e-11,11234,1025456,643975056
1071,2120878834,79038302,1.0670170770000001e-11,11150,1025456,645000512
1072,2053204500,79038303,1.0670170904999999e-11,11171,1025456,646025968
1073,2111530792,79129135,1.0682433225e-11,11192,1025456,647051424
1074,2049292416,79038303,1.0670170904999999e-11,11192,1025456,648076880
1075,2143889167,79038303,1.0670170904999999e-11,11192,1025456,649102336
1076,2052995500,79038304,1.0670171040000001e-11,11213,1025456,650127792
1077,2108398417,79038304,1.0670171040000001e-11,11213,1025456,651153248
1078,2067856542,79129136,1.068243336e-11,11213,1025456,652178704
1079,2134941917,79038304,1.0670171040000001e-11,11213,1025456,653204160
1080,2188658542,79038304,1.0670171040000001e-11,11213,1025456,654229616
1081,2509907541,79038302,1.0670170770000001e-11,11150,1025456,655255072
1082,2501874333,79129135,1.0682433225e-11,11171,1025456,656280528
1083,2257539417,79038303,1.0670170904999999e-11,11171,1025456,657305984
1084,3139806667,79038303,1.0670170904999999e-11,11192,1025456,658331440
1085,2068428042,79038303,1.0670170904999999e-11,11192,1025456,659356896
1086,2053110875,79129513,1.0682484255e-11,23478,1025904,660382800
1087,2065783583,79038304,1.0670171040000001e-11,11213,1025456,661408256
1088,2052644833,79038304,1.0670171040000001e-11,11213,1025456,662433712
1089,2051689000,79038304,1.0670171040000001e-11,11213,1025456,663459168
1090,2060782083,79038305,1.0670171174999998e-11,11234,1025456,664484624
1091,2058899625,79129134,1.068243309e-11,11150,1025456,665510080
1092,2050622333,79038303,1.0670170904999999e-11,11171,1025456,666535536
1093,2050506458,79038303,1.0670170904999999e-11,11192,1025456,667560992
1094,2045398000,79038303,1.0670170904999999e-11,11192,1025456,668586448
1095,2052587375,79038303,1.0670170904999999e-11,11192,1025456,669611904
1096,2064205000,79129135,1.0682433225e-11,11192,1025456,670637360
1097,2064620208,79038304,1.0670171040000001e-11,11213,1025456,671662816
1098,2061124125,79038304,1.0670171040000001e-11,11213,1025456,672688272
1099,2071852000,79038304,1.0670171040000001e-11,11213,1025456,673713728
1100,2888188250,79129136,1.068243336e-11,11213,1025456,674739184
1101,4453784417,79038298,1.0670170229999999e-11,11024,1025456,675764640
1102,2556571291,79038300,1.0670170499999999e-11,11066,1025456,676790096
1103,4317755834,79129505,1.0682483174999999e-11,23220,1025904,677816000
1104,2057033875,79038301,1.0670170635e-11,11108,1025456,678841456
1105,22008460125,138186796,1.865521746e-11,11150,-112939404,565902052
1106,2059557875,79038302,1.0670170770000001e-11,11150,1025456,566927508
1107,2055243875,79038302,1.0670170770000001e-11,11150,1025456,567952964
1108,2049820959,79038302,1.0670170770000001e-11,11150,1025456,568978420
1109,2049218417,79038302,1.0670170770000001e-11,11150,1025456,570003876
1110,2050713084,79151876,1.0685503260000001e-11,11150,1025456,571029332
1111,2051215542,79038300,1.0670170499999999e-11,11087,1025456,572054788
1112,2052413875,79038301,1.0670170635e-11,11108,1025456,573080244
1113,2050100833,79038301,1.0670170635e-11,11129,1025456,574105700
1114,2053417458,79038302,1.0670170770000001e-11,11150,1025456,575131156
1115,2057470459,79151876,1.0685503260000001e-11,11150,1025456,576156612
1116,2108433416,79038302,1.0670170770000001e-11,11150,1025456,577182068
1117,2059480250,79038302,1.0670170770000001e-11,11150,1025456,578207524
1118,2114674833,79038303,1.0670170904999999e-11,11171,1025456,579232980
1119,2063769166,79151877,1.0685503395e-11,11171,1025456,580258436
1120,2332865167,79038673,1.0670220855e-11,23193,1025904,581284340
1121,4193700250,79038316,1.067017266e-11,11592,1025456,582309796
1122,2974893000,79151891,1.0685505285000001e-11,11613,1025456,583335252
1123,3810846333,79038317,1.0670172795e-11,11634,1025456,584360708
1124,2120401916,79038317,1.0670172795e-11,11634,1025456,585386164
1125,2057131375,79151891,1.0685505285000001e-11,11634,1025456,586411620
1126,2057441542,79038318,1.0670172929999999e-11,11655,1025456,587437076
1127,2057298833,79038318,1.0670172929999999e-11,11655,1025456,588462532
1128,2050685625,79038318,1.0670172929999999e-11,11655,1025456,589487988
1129,27171783584,79333610,1.071003735e-11,11655,1025456,590513444
1130,2064371292,79038318,1.0670172929999999e-11,11655,1025456,591538900
1131,2054496458,79151890,1.0685505149999999e-11,11592,1025456,592564356
1132,2050917708,79038317,1.0670172795e-11,11613,1025456,593589812
1133,2059021000,79038317,1.0670172795e-11,11613,1025456,594615268
1134,2074431000,79038317,1.0670172795e-11,11634,1025456,595640724
1135,2049857166,79038317,1.0670172795e-11,11634,1025456,596666180
1136,2050606625,79151891,1.0685505285000001e-11,11634,1025456,597691636
1137,2060099375,79039566,1.0670341409999998e-11,52228,1026708,598718344
1138,2318454167,79038320,1.0670173200000002e-11,11731,1025456,599743800
1139,2122541708,79038321,1.0670173334999999e-11,11752,1025456,600769256
1140,2376257417,79151895,1.0685505825e-11,11752,1025456,601794712
1141,2294419958,79038318,1.0670172929999999e-11,11668,1025456,602820168
1142,2353118416,79038319,1.0670173065e-11,11689,1025456,603845624
1143,3861967000,79038319,1.0670173065e-11,11710,1025456,604871080
1144,2068772000,79151893,1.0685505555e-11,11710,1025456,605896536
1145,2053379000,79038319,1.0670173065e-11,11710,1025456,606921992
1146,2051228292,79038319,1.0670173065e-11,11710,1025456,607947448
1147,2053888000,79038320,1.0670173200000002e-11,11731,1025456,608972904
1148,2052354334,79151894,1.0685505690000001e-11,11731,1025456,609998360
1149,2057081833,79038320,1.0670173200000002e-11,11731,1025456,611023816
1150,2056579500,79038320,1.0670173200000002e-11,11731,1025456,612049272
1151,2057598750,79038318,1.0670172929999999e-11,11668,1025456,613074728
1152,2051553458,79038319,1.0670173065e-11,11689,1025456,614100184
1153,2051295750,79151893,1.0685505555e-11,11689,1025456,615125640
1154,2050147667,79038749,1.0670231115000001e-11,25691,1025904,616151544
1155,2051854042,79038320,1.0670173200000002e-11,11731,1025456,617177000
1156,2052452833,79038320,1.0670173200000002e-11,11731,1025456,618202456
1157,2048488125,79038320,1.0670173200000002e-11,11731,1025456,619227912
1158,2050991916,79151894,1.0685505690000001e-11,11731,1025456,620253368
1159,2053073041,79038320,1.0670173200000002e-11,11731,1025456,621278824
1160,2050278250,79038320,1.0670173200000002e-11,11731,1025456,622304280
1161,2051823208,79038318,1.0670172929999999e-11,11668,1025456,623329736
1162,2085855708,79038319,1.0670173065e-11,11689,1025456,624355192
1163,2931350000,79151893,1.0685505555e-11,11689,1025456,625380648
1164,4136379541,79038319,1.0670173065e-11,11710,1025456,626406104
1165,2710217709,79038319,1.0670173065e-11,11710,1025456,627431560
1166,4500463708,79038319,1.0670173065e-11,11710,1025456,628457016
1167,2360466416,79038319,1.0670173065e-11,11710,1025456,629482472
1168,2052070167,79038320,1.0670173200000002e-11,11731,1025456,630507928
1169,2056983250,79038320,1.0670173200000002e-11,11731,1025456,631533384
1170,2053648292,79038320,1.0670173200000002e-11,11731,1025456,632558840
1171,2050586334,79038744,1.0670230440000001e-11,25517,1025904,633584744
1172,2053946792,79038319,1.0670173065e-11,11710,1025456,634610200
1173,2051396833,79151894,1.0685505690000001e-11,11731,1025456,635635656
1174,2049329417,79038320,1.0670173200000002e-11,11731,1025456,636661112
1175,2066881125,79038321,1.0670173334999999e-11,11752,1025456,637686568
1176,2088591875,79038321,1.0670173334999999e-11,11752,1025456,638712024
1177,2056248250,79038321,1.0670173334999999e-11,11752,1025456,639737480
1178,2049954833,79151895,1.0685505825e-11,11752,1025456,640762936
1179,2056663625,79038321,1.0670173334999999e-11,11752,1025456,641788392
1180,2049220958,79038321,1.0670173334999999e-11,11752,1025456,642813848
1181,2064752500,79038319,1.0670173065e-11,11689,1025456,643839304
1182,2496298792,79038319,1.0670173065e-11,11710,1025456,644864760
1183,2601908833,79151893,1.0685505555e-11,11710,1025456,645890216
1184,4211372333,79038320,1.0670173200000002e-11,11731,1025456,646915672
1185,3068045209,79038320,1.0670173200000002e-11,11731,1025456,647941128
1186,3861152917,79151894,1.0685505690000001e-11,11731,1025456,648966584
1187,2050952333,79038320,1.0670173200000002e-11,11731,1025456,649992040
1188,2052738958,79038743,1.0670230304999999e-11,25469,1025904,651017944
1189,2050433000,79151895,1.0685505825e-11,11773,1025456,652043400
1190,2069926416,79038321,1.0670173334999999e-11,11773,1025456,653068856
1191,2055574166,79038319,1.0670173065e-11,11689,1025456,654094312
1192,2049548459,79038319,1.0670173065e-11,11710,1025456,655119768
1193,2051951250,79038320,1.0670173200000002e-11,11731,1025456,656145224
1194,2061494584,79151894,1.0685505690000001e-11,11731,1025456,657170680
1195,2064847042,79038320,1.0670173200000002e-11,11731,1025456,658196136
1196,2058477041,79038321,1.0670173334999999e-11,11752,1025456,659221592
1197,2058886958,79038321,1.0670173334999999e-11,11752,1025456,660247048
1198,2064732791,79038321,1.0670173334999999e-11,11752,1025456,661272504
1199,2066505208,79151895,1.0685505825e-11,11752,1025456,662297960
1200,2071828250,79038321,1.0670173334999999e-11,11752,1025456,663323416
1201,2200741041,79038314,1.067017239e-11,11542,1025456,664348872
1202,2316672959,79038316,1.067017266e-11,11584,1025456,665374328
1203,2983822416,79151890,1.0685505149999999e-11,11584,1025456,666399784
1204,2319997167,79038317,1.0670172795e-11,11626,1025456,667425240
1205,2690585959,79038735,1.0670229225e-11,25232,1025904,668451144
1206,2079209292,79038318,1.0670172929999999e-11,11668,1025456,669476600
1207,2402443709,79151892,1.0685505419999999e-11,11668,1025456,670502056
1208,2053530583,79038318,1.0670172929999999e-11,11668,1025456,671527512
1209,2048912584,79038318,1.0670172929999999e-11,11668,1025456,672552968
1210,2074600208,79038318,1.0670172929999999e-11,11668,1025456,673578424
1211,2078118333,79151891,1.0685505285000001e-11,11626,1025456,674603880
1212,2063080000,79038317,1.0670172795e-11,11647,1025456,675629336
1213,2061500000,79038318,1.0670172929999999e-11,11668,1025456,676654792
1214,2096075417,79038318,1.0670172929999999e-11,11668,1025456,677680248
1215,2063796625,79038318,1.0670172929999999e-11,11668,1025456,678705704
1216,2102113667,79151892,1.0685505419999999e-11,11668,1025456,679731160
1217,2064659916,79038319,1.0670173065e-11,11689,1025456,680756616
1218,2107732000,79038319,1.0670173065e-11,11689,1025456,681782072
1219,2066409084,79038319,1.0670173065e-11,11689,1025456,682807528
1220,2102340000,79038319,1.0670173065e-11,11689,1025456,683832984
1221,2064929208,79151891,1.0685505285000001e-11,11626,1025456,684858440
1222,2089320666,79038731,1.0670228685e-11,25100,1025904,685884344
1223,2060856792,79038319,1.0670173065e-11,11689,1025456,686909800
1224,2115649041,79038319,1.0670173065e-11,11689,1025456,687935256
1225,2072594750,79038319,1.0670173065e-11,11710,1025456,688960712
1226,3480959958,79151893,1.0685505555e-11,11710,1025456,689986168
1227,3907165291,79038319,1.0670173065e-11,11710,1025456,691011624
1228,2335996292,79038319,1.0670173065e-11,11710,1025456,692037080
1229,2584912417,79038319,1.0670173065e-11,11710,1025456,693062536
1230,4067080875,79038319,1.0670173065e-11,11710,1025456,694087992
1231,2049271291,79038317,1.0670172795e-11,11647,1025456,695113448
1232,2052825958,79151892,1.0685505419999999e-11,11668,1025456,696138904
1233,2053962542,79038318,1.0670172929999999e-11,11668,1025456,697164360
1234,2067967000,79038319,1.0670173065e-11,11689,1025456,698189816
1235,2050443542,79038319,1.0670173065e-11,11689,1025456,699215272
1236,2048650875,79038319,1.0670173065e-11,11689,1025456,700240728
1237,2056497041,79151893,1.0685505555e-11,11689,1025456,701266184
1238,2064077333,79038319,1.0670173065e-11,11710,1025456,702291640
1239,2058612833,79038730,1.067022855e-11,25052,1025904,703317544
1240,2050870000,79038321,1.0670173334999999e-11,11752,1025456,704343000
1241,2054871416,79038318,1.0670172929999999e-11,11668,1025456,705368456
1242,2060525333,79151893,1.0685505555e-11,11689,1025456,706393912
1243,2050268167,79038319,1.0670173065e-11,11710,1025456,707419368
1244,2051251417,79038319,1.0670173065e-11,11710,1025456,708444824
1245,2401551417,79038319,1.0670173065e-11,11710,1025456,709470280
1246,2210609625,79151894,1.0685505690000001e-11,11731,1025456,710495736
1247,2604849625,79038320,1.0670173200000002e-11,11731,1025456,711521192
1248,3948770625,79038320,1.0670173200000002e-11,11731,1025456,712546648
1249,2475458375,79151894,1.0685505690000001e-11,11731,1025456,713572104
1250,2515505542,79038320,1.0670173200000002e-11,11731,1025456,714597560
1251,2049627084,79038318,1.0670172929999999e-11,11668,1025456,715623016
1252,2051747167,79038319,1.0670173065e-11,11689,1025456,716648472
1253,2050329666,79151893,1.0685505555e-11,11689,1025456,717673928
1254,2049990833,79038319,1.0670173065e-11,11710,1025456,718699384
1255,2048958958,79038319,1.0670173065e-11,11710,1025456,719724840
1256,2050458125,79038726,1.0670228010000001e-11,24920,1025904,720750744
1257,2049750333,79038320,1.0670173200000002e-11,11731,1025456,721776200
1258,2046423583,79151894,1.0685505690000001e-11,11731,1025456,722801656
1259,2073014000,79038320,1.0670173200000002e-11,11731,1025456,723827112
1260,2057521750,79038321,1.0670173334999999e-11,11752,1025456,724852568
1261,2132887333,79038318,1.0670172929999999e-11,11668,1025456,725878024
1262,2053362833,79038319,1.0670173065e-11,11689,1025456,726903480
1263,2095462667,79151893,1.0685505555e-11,11710,1025456,727928936
1264,2058940250,79038319,1.0670173065e-11,11710,1025456,728954392
1265,2105857708,79038319,1.0670173065e-11,11710,1025456,729979848
1266,2057830459,79038319,1.0670173065e-11,11710,1025456,731005304
1267,2097971500,79038320,1.0670173200000002e-11,11731,1025456,732030760
1268,2069234500,79151894,1.0685505690000001e-11,11731,1025456,733056216
1269,2110807833,79038320,1.0670173200000002e-11,11731,1025456,734081672
1270,2054481917,79038320,1.0670173200000002e-11,11731,1025456,735107128
1271,2091802709,79038318,1.0670172929999999e-11,11668,1025456,736132584
1272,2053061583,79038319,1.0670173065e-11,11689,1025456,737158040
1273,2153696583,79152295,1.0685559825e-11,24767,1025904,738183944
1274,2087061417,79038319,1.0670173065e-11,11710,1025456,739209400
1275,2544902500,79038320,1.0670173200000002e-11,11731,1025456,740234856
1276,4071403708,79151894,1.0685505690000001e-11,11731,1025456,741260312
1277,2931170042,79038320,1.0670173200000002e-11,11731,1025456,742285768
1278,2420312792,79038320,1.0670173200000002e-11,11731,1025456,743311224
1279,2051357250,79038320,1.0670173200000002e-11,11731,1025456,744336680
1280,2052527334,79151894,1.0685505690000001e-11,11731,1025456,745362136
1281,2052561416,79038318,1.0670172929999999e-11,11668,1025456,746387592
1282,2050301000,79038319,1.0670173065e-11,11689,1025456,747413048
1283,2056359542,79038319,1.0670173065e-11,11689,1025456,748438504
1284,2061247958,79038319,1.0670173065e-11,11710,1025456,749463960
1285,2081283875,79151893,1.0685505555e-11,11710,1025456,750489416
1286,2059543917,79038319,1.0670173065e-11,11710,1025456,751514872
1287,2105391708,79038319,1.0670173065e-11,11710,1025456,752540328
1288,2058409250,79038320,1.0670173200000002e-11,11731,1025456,753565784
1289,2103208917,79038320,1.0670173200000002e-11,11731,1025456,754591240
1290,2056366667,79152292,1.0685559419999999e-11,24677,1025904,755617144
1291,2130642750,79038318,1.0670172929999999e-11,11668,1025456,756642600
1292,2082832208,79038319,1.0670173065e-11,11689,1025456,757668056
1293,2193826750,79038319,1.0670173065e-11,11710,1025456,758693512
1294,3997796041,79151893,1.0685505555e-11,11710,1025456,759718968
1295,2518028750,79038319,1.0670173065e-11,11710,1025456,760744424
1296,3799341375,79151894,1.0685505690000001e-11,11731,1025456,761769880
1297,2295806042,79038320,1.0670173200000002e-11,11731,1025456,762795336
1298,2050169375,79038320,1.0670173200000002e-11,11731,1025456,763820792
1299,2050180708,79038320,1.0670173200000002e-11,11731,1025456,764846248
1300,2050620125,79038320,1.0670173200000002e-11,11731,1025456,765871704
1301,2051656750,79151888,1.068550488e-11,11542,1025456,766897160
1302,2050774667,79038316,1.067017266e-11,11584,1025456,767922616
1303,2050324167,79038316,1.067017266e-11,11584,1025456,768948072
1304,2053541333,79038317,1.0670172795e-11,11626,1025456,769973528
1305,2050863916,79151891,1.0685505285000001e-11,11626,1025456,770998984
1306,2050577750,79038317,1.0670172795e-11,11626,1025456,772024440
1307,2050889375,79038711,1.0670225985e-11,24440,1025904,773050344
1308,2055217208,79038318,1.0670172929999999e-11,11668,1025456,774075800
1309,2053912042,79038319,1.0670173065e-11,11710,1025456,775101256
1310,2047895708,79151893,1.0685505555e-11,11710,1025456,776126712
1311,2116287791,79038317,1.0670172795e-11,11626,1025456,777152168
1312,2052118166,79038317,1.0670172795e-11,11647,1025456,778177624
1313,2087841000,79038318,1.0670172929999999e-11,11668,1025456,779203080
1314,2074287709,79038318,1.0670172929999999e-11,11668,1025456,780228536
1315,2198824416,79151892,1.0685505419999999e-11,11668,1025456,781253992
1316,2452409333,79038318,1.0670172929999999e-11,11668,1025456,782279448
1317,2618238292,79038319,1.0670173065e-11,11689,1025456,783304904
1318,34176026333,79447185,1.0725369974999998e-11,11689,1025456,784330360
1319,2053541250,79038319,1.0670173065e-11,11689,1025456,785355816
1320,2058055875,79038319,1.0670173065e-11,11689,1025456,786381272
1321,2063617375,79151891,1.0685505285000001e-11,11626,1025456,787406728
1322,2050109500,79038317,1.0670172795e-11,11647,1025456,788432184
1323,2065044583,79038317,1.0670172795e-11,11647,1025456,789457640
1324,2057344416,79038708,1.067022558e-11,24329,1025904,790483544
1325,2055715458,79038319,1.0670173065e-11,11710,1025456,791509000
1326,2063386708,79151893,1.0685505555e-11,11710,1025456,792534456
1327,2049593291,79038319,1.0670173065e-11,11710,1025456,793559912
1328,2056302250,79038319,1.0670173065e-11,11710,1025456,794585368
1329,2124310500,79038319,1.0670173065e-11,11710,1025456,795610824
1330,2057943583,79038319,1.0670173065e-11,11710,1025456,796636280
1331,2112124708,79151891,1.0685505285000001e-11,11647,1025456,797661736
1332,2060734375,79038318,1.0670172929999999e-11,11668,1025456,798687192
1333,2147623416,79038318,1.0670172929999999e-11,11668,1025456,799712648
1334,2115842292,79038319,1.0670173065e-11,11689,1025456,800738104
1335,2357363792,79038319,1.0670173065e-11,11689,1025456,801763560
1336,2270271417,79151893,1.0685505555e-11,11689,1025456,802789016
1337,2807482291,79038319,1.0670173065e-11,11689,1025456,803814472
1338,3631492167,79038319,1.0670173065e-11,11710,1025456,804839928
1339,2351579166,79151893,1.0685505555e-11,11710,1025456,805865384
1340,2054578375,79038319,1.0670173065e-11,11710,1025456,806890840
1341,2068569125,79038703,1.0670224904999999e-11,24176,1025904,807916744
1342,2050148000,79038318,1.0670172929999999e-11,11668,1025456,808942200
1343,2059934958,79038319,1.0670173065e-11,11689,1025456,809967656
1344,2057279375,79151893,1.0685505555e-11,11689,1025456,810993112
1345,2076387875,79038319,1.0670173065e-11,11710,1025456,812018568
1346,2049192875,79038319,1.0670173065e-11,11710,1025456,813044024
1347,2117566959,79038319,1.0670173065e-11,11710,1025456,814069480
1348,2049620250,79038319,1.0670173065e-11,11710,1025456,815094936
1349,2117538958,79151893,1.0685505555e-11,11710,1025456,816120392
1350,2050010417,79038319,1.0670173065e-11,11710,1025456,817145848
1351,2114432667,79038317,1.0670172795e-11,11647,1025456,818171304
1352,2051027958,79038318,1.0670172929999999e-11,11668,1025456,819196760
1353,2107666917,79151892,1.0685505419999999e-11,11668,1025456,820222216
1354,2049874208,79038319,1.0670173065e-11,11689,1025456,821247672
1355,2111653625,79038319,1.0670173065e-11,11689,1025456,822273128
1356,2050344667,79038319,1.0670173065e-11,11689,1025456,823298584
1357,2110234500,79038319,1.0670173065e-11,11689,1025456,824324040
1358,2049212083,79152275,1.0685557125e-11,24107,1025904,825349944
1359,2135100542,79038321,1.0670173334999999e-11,11752,1025456,826375400
1360,2051693250,79038321,1.0670173334999999e-11,11752,1025456,827400856
1361,2109560500,79038318,1.0670172929999999e-11,11668,1025456,828426312
1362,2050746583,79038319,1.0670173065e-11,11689,1025456,829451768
1363,2110583500,79151893,1.0685505555e-11,11710,1025456,830477224
1364,2049350833,79038319,1.0670173065e-11,11710,1025456,831502680
1365,2106343333,79038319,1.0670173065e-11,11710,1025456,832528136
1366,2050814709,79038320,1.0670173200000002e-11,11731,1025456,833553592
1367,2121457292,79038320,1.0670173200000002e-11,11731,1025456,834579048
1368,2141146042,79151894,1.0685505690000001e-11,11731,1025456,835604504
1369,2565313209,79038320,1.0670173200000002e-11,11731,1025456,836629960
1370,3747139375,79038320,1.0670173200000002e-11,11731,1025456,837655416
1371,2730950041,79151892,1.0685505419999999e-11,11668,1025456,838680872
1372,2281958750,79038319,1.0670173065e-11,11689,1025456,839706328
1373,2058272333,79038319,1.0670173065e-11,11689,1025456,840731784
1374,2066300334,79038319,1.0670173065e-11,11710,1025456,841757240
1375,2049662750,79038697,1.0670224094999999e-11,23996,1025904,842783144
1376,2050011250,79151894,1.0685505690000001e-11,11731,1025456,843808600
1377,2064900958,79038320,1.0670173200000002e-11,11731,1025456,844834056
1378,2052133375,79038320,1.0670173200000002e-11,11731,1025456,845859512
1379,2057340792,79038320,1.0670173200000002e-11,11731,1025456,846884968
1380,2052071916,79151894,1.0685505690000001e-11,11731,1025456,847910424
1381,2057495667,79038318,1.0670172929999999e-11,11668,1025456,848935880
1382,27166308375,152999596,2.0654945459999998e-11,11689,-141174360,707761520
1383,2053626333,79038319,1.0670173065e-11,11710,1025456,708786976
1384,2074976125,79180275,1.0689337124999999e-11,11710,1025456,709812432
1385,2051288125,79038319,1.0670173065e-11,11710,1025456,710837888
1386,2049071125,79038319,1.0670173065e-11,11710,1025456,711863344
1387,2062247833,79038320,1.0670173200000002e-11,11731,1025456,712888800
1388,2589272167,79038320,1.0670173200000002e-11,11731,1025456,713914256
1389,2305913084,79180276,1.068933726e-11,11731,1025456,714939712
1390,2663375584,79038320,1.0670173200000002e-11,11731,1025456,715965168
1391,2611897000,79038318,1.0670172929999999e-11,11668,1025456,716990624
1392,2908399291,79180648,1.068938748e-11,23822,1025904,718016528
1393,2552734250,79038319,1.0670173065e-11,11710,1025456,719041984
1394,2058287916,79038319,1.0670173065e-11,11710,1025456,720067440
1395,2051285833,79038320,1.0670173200000002e-11,11731,1025456,721092896
1396,2052403667,79038320,1.0670173200000002e-11,11731,1025456,722118352
1397,2050268667,79180276,1.068933726e-11,11731,1025456,723143808
1398,2051498458,79038320,1.0670173200000002e-11,11731,1025456,724169264
1399,2050325167,79038320,1.0670173200000002e-11,11731,1025456,725194720
1400,2050014334,79038320,1.0670173200000002e-11,11731,1025456,726220176
1401,2049156000,79180270,1.0689336449999999e-11,11542,1025456,727245632
1402,2056349667,79038316,1.067017266e-11,11584,1025456,728271088
1403,2050036958,79038316,1.067017266e-11,11584,1025456,729296544
1404,2076999667,79038317,1.0670172795e-11,11626,1025456,730322000
1405,2060701125,79038317,1.0670172795e-11,11626,1025456,731347456
1406,2092765750,79180273,1.0689336854999999e-11,11626,1025456,732372912
1407,2057110542,79038317,1.0670172795e-11,11626,1025456,733398368
1408,2198218334,79038318,1.0670172929999999e-11,11668,1025456,734423824
1409,2521463542,79038688,1.067022288e-11,23690,1025904,735449728
1410,2882838000,79180290,1.0689339149999999e-11,12173,1025456,736475184
1411,4049584291,79038331,1.0670174685e-11,12089,1025456,737500640
1412,2886778333,79038332,1.067017482e-11,12110,1025456,738526096
1413,2301119916,79180288,1.068933888e-11,12131,1025456,739551552
1414,2050509417,79038332,1.067017482e-11,12131,1025456,740577008
1415,2048718000,79038332,1.067017482e-11,12131,1025456,741602464
1416,2055425083,79038333,1.0670174955e-11,12152,1025456,742627920
1417,2069052167,79038333,1.0670174955e-11,12152,1025456,743653376
1418,2061893958,79180289,1.0689339015e-11,12152,1025456,744678832
1419,2049327792,79038333,1.0670174955e-11,12152,1025456,745704288
1420,2070850375,79038333,1.0670174955e-11,12152,1025456,746729744
1421,2059084000,79038331,1.0670174685e-11,12089,1025456,747755200
1422,2050832542,79038332,1.067017482e-11,12110,1025456,748780656
1423,2048758791,79180288,1.068933888e-11,12110,1025456,749806112
1424,2058857333,79038332,1.067017482e-11,12131,1025456,750831568
1425,2061338542,79038332,1.067017482e-11,12131,1025456,751857024
1426,2065184709,79039577,1.0670342895e-11,52593,1026708,752883732
1427,2062806417,79038320,1.0670173200000002e-11,11731,1025456,753909188
1428,2070993500,79180276,1.068933726e-11,11731,1025456,754934644
1429,2723621458,79038320,1.0670173200000002e-11,11731,1025456,755960100
1430,3838229834,79038321,1.0670173334999999e-11,11752,1025456,756985556
1431,2980556084,79180274,1.0689336990000001e-11,11668,1025456,758011012
1432,2436838333,79038319,1.0670173065e-11,11689,1025456,759036468
1433,2989265041,79038319,1.0670173065e-11,11710,1025456,760061924
1434,2068784916,79180275,1.0689337124999999e-11,11710,1025456,761087380
1435,2059889667,79038319,1.0670173065e-11,11710,1025456,762112836
1436,2064234958,79038319,1.0670173065e-11,11710,1025456,763138292
1437,2058820709,79038320,1.0670173200000002e-11,11731,1025456,764163748
1438,2063144041,79038320,1.0670173200000002e-11,11731,1025456,765189204
1439,2055583792,79180276,1.068933726e-11,11731,1025456,766214660
1440,2053746916,79038320,1.0670173200000002e-11,11731,1025456,767240116
1441,2049494625,79038318,1.0670172929999999e-11,11668,1025456,768265572
1442,2060011708,79038319,1.0670173065e-11,11689,1025456,769291028
1443,2050084792,79038749,1.0670231115000001e-11,25691,1025904,770316932
1444,2047828375,79180276,1.068933726e-11,11731,1025456,771342388
1445,2050549000,79038321,1.0670173334999999e-11,11752,1025456,772367844
1446,2051029458,79038321,1.0670173334999999e-11,11752,1025456,773393300
1447,2050406084,79038321,1.0670173334999999e-11,11752,1025456,774418756
1448,2049630125,79038321,1.0670173334999999e-11,11752,1025456,775444212
1449,2049762792,79180277,1.0689337395e-11,11752,1025456,776469668
1450,2050258583,79038321,1.0670173334999999e-11,11752,1025456,777495124
1451,2050661667,79038319,1.0670173065e-11,11689,1025456,778520580
1452,2050078708,79038319,1.0670173065e-11,11710,1025456,779546036
1453,2049739625,79038319,1.0670173065e-11,11710,1025456,780571492
1454,2048806500,79180276,1.068933726e-11,11731,1025456,781596948
1455,2050196417,79038320,1.0670173200000002e-11,11731,1025456,782622404
1456,2056865125,79038320,1.0670173200000002e-11,11731,1025456,783647860
1457,2853369959,79038320,1.0670173200000002e-11,11731,1025456,784673316
1458,2151432917,79180277,1.0689337395e-11,11752,1025456,785698772
1459,2466585792,79038321,1.0670173334999999e-11,11752,1025456,786724228
1460,2382516875,79038747,1.0670230845000001e-11,25622,1025904,787750132
1461,2512387459,79038319,1.0670173065e-11,11689,1025456,788775588
1462,2320828292,79180275,1.0689337124999999e-11,11710,1025456,789801044
1463,2053258542,79038320,1.0670173200000002e-11,11731,1025456,790826500
1464,2049507541,79038320,1.0670173200000002e-11,11731,1025456,791851956
1465,2052270292,79038320,1.0670173200000002e-11,11731,1025456,792877412
1466,2049695333,79180277,1.0689337395e-11,11752,1025456,793902868
1467,2057135833,79038321,1.0670173334999999e-11,11752,1025456,794928324
1468,2051859084,79038321,1.0670173334999999e-11,11752,1025456,795953780
1469,2069273125,79038321,1.0670173334999999e-11,11752,1025456,796979236
1470,2050366583,79038321,1.0670173334999999e-11,11752,1025456,798004692
1471,2053994416,79180275,1.0689337124999999e-11,11689,1025456,799030148
1472,2111644375,79038319,1.0670173065e-11,11710,1025456,800055604
1473,2058926083,79038319,1.0670173065e-11,11710,1025456,801081060
1474,2088962625,79038320,1.0670173200000002e-11,11731,1025456,802106516
1475,2055161958,79038320,1.0670173200000002e-11,11731,1025456,803131972
1476,2115508083,79180276,1.068933726e-11,11731,1025456,804157428
1477,2119744875,79038743,1.0670230304999999e-11,25469,1025904,805183332
1478,2872581333,79038321,1.0670173334999999e-11,11773,1025456,806208788
1479,2580419542,79038322,1.0670173470000001e-11,11794,1025456,807234244
1480,2286843625,79180278,1.068933753e-11,11794,1025456,808259700
1481,3916747708,79038319,1.0670173065e-11,11710,1025456,809285156
1482,2479230291,79038320,1.0670173200000002e-11,11731,1025456,810310612
1483,2066729041,79180277,1.0689337395e-11,11752,1025456,811336068
1484,2052181250,79038321,1.0670173334999999e-11,11752,1025456,812361524
1485,2070647125,79038321,1.0670173334999999e-11,11752,1025456,813386980
1486,2057181750,79038321,1.0670173334999999e-11,11752,1025456,814412436
1487,2070207375,79038321,1.0670173334999999e-11,11773,1025456,815437892
1488,2051173333,79180277,1.0689337395e-11,11773,1025456,816463348
1489,2049659416,79038321,1.0670173334999999e-11,11773,1025456,817488804
1490,2049520958,79038321,1.0670173334999999e-11,11773,1025456,818514260
1491,2053435916,79038319,1.0670173065e-11,11710,1025456,819539716
1492,2054706709,79038320,1.0670173200000002e-11,11731,1025456,820565172
1493,2050859042,79180276,1.068933726e-11,11731,1025456,821590628
1494,2050821500,79038739,1.0670229765e-11,25337,1025904,822616532
1495,2049501417,79038321,1.0670173334999999e-11,11773,1025456,823641988
1496,2049569792,79038321,1.0670173334999999e-11,11773,1025456,824667444
1497,2049664458,79038321,1.0670173334999999e-11,11773,1025456,825692900
1498,2050339333,79180277,1.0689337395e-11,11773,1025456,826718356
1499,2049338666,79038321,1.0670173334999999e-11,11773,1025456,827743812
1500,2049462042,79038321,1.0670173334999999e-11,11773,1025456,828769268
1501,2050305000,79038315,1.0670172525e-11,11563,1025456,829794724
1502,2051028333,79038316,1.067017266e-11,11605,1025456,830820180
1503,2049939958,79180272,1.0689336719999998e-11,11605,1025456,831845636
1504,2056085208,79038317,1.0670172795e-11,11647,1025456,832871092
1505,2047049583,79038317,1.0670172795e-11,11647,1025456,833896548
1506,2163871792,79038317,1.0670172795e-11,11647,1025456,834922004
1507,2512625834,79180273,1.0689336854999999e-11,11647,1025456,835947460
1508,2502334166,79038319,1.0670173065e-11,11689,1025456,836972916
1509,3735870417,79038319,1.0670173065e-11,11689,1025456,837998372
1510,2670676791,79038319,1.0670173065e-11,11689,1025456,839023828
1511,3639637916,79180687,1.0689392745e-11,25079,1025904,840049732
1512,2047966083,79038318,1.0670172929999999e-11,11668,1025456,841075188
1513,2051560834,79038319,1.0670173065e-11,11689,1025456,842100644
1514,2053142708,79180275,1.0689337124999999e-11,11689,1025456,843126100
1515,2048162292,79038319,1.0670173065e-11,11710,1025456,844151556
1516,2092842791,79038319,1.0670173065e-11,11710,1025456,845177012
1517,2064137500,79038319,1.0670173065e-11,11710,1025456,846202468
1518,2111935334,79038319,1.0670173065e-11,11710,1025456,847227924
1519,2056509625,79180275,1.0689337124999999e-11,11710,1025456,848253380
1520,2098562333,79038319,1.0670173065e-11,11710,1025456,849278836
1521,2074494458,79038317,1.0670172795e-11,11647,1025456,850304292
1522,2092302458,79038318,1.0670172929999999e-11,11668,1025456,851329748
1523,2079410666,79038318,1.0670172929999999e-11,11668,1025456,852355204
1524,2099680875,79180275,1.0689337124999999e-11,11689,1025456,853380660
1525,2069928792,79038319,1.0670173065e-11,11689,1025456,854406116
1526,2253911750,79038319,1.0670173065e-11,11689,1025456,855431572
1527,3663460916,79038319,1.0670173065e-11,11689,1025456,856457028
1528,2857342583,79038729,1.0670228415000001e-11,25031,1025904,857482932
1529,2242483000,79038321,1.0670173334999999e-11,11752,1025456,858508388
1530,2378508958,79038321,1.0670173334999999e-11,11752,1025456,859533844
1531,2182599833,79180274,1.0689336990000001e-11,11668,1025456,860559300
1532,2063766875,79038319,1.0670173065e-11,11689,1025456,861584756
1533,2052438458,79038319,1.0670173065e-11,11710,1025456,862610212
1534,2061997375,79038319,1.0670173065e-11,11710,1025456,863635668
1535,2051014000,79038319,1.0670173065e-11,11710,1025456,864661124
1536,2061407792,79180276,1.068933726e-11,11731,1025456,865686580
1537,2052782625,79038320,1.0670173200000002e-11,11731,1025456,866712036
1538,2049866375,79038320,1.0670173200000002e-11,11731,1025456,867737492
1539,2057501625,79038320,1.0670173200000002e-11,11731,1025456,868762948
1540,2048761583,79038320,1.0670173200000002e-11,11731,1025456,869788404
1541,2050105792,79180274,1.0689336990000001e-11,11668,1025456,870813860
1542,2047810333,79038319,1.0670173065e-11,11689,1025456,871839316
1543,2067925666,79038319,1.0670173065e-11,11689,1025456,872864772
1544,33381109458,79549362,1.073916387e-11,11710,1025456,873890228
1545,2121497083,79038726,1.0670228010000001e-11,24920,1025904,874916132
1546,2051867250,79038321,1.0670173334999999e-11,11752,1025456,875941588
1547,2105510042,79038321,1.0670173334999999e-11,11752,1025456,876967044
1548,2056420458,79038321,1.0670173334999999e-11,11752,1025456,877992500
1549,2224159416,79180277,1.0689337395e-11,11752,1025456,879017956
1550,2486660417,79038321,1.0670173334999999e-11,11752,1025456,880043412
1551,2899769291,79038319,1.0670173065e-11,11689,1025456,881068868
1552,2502824333,79180275,1.0689337124999999e-11,11710,1025456,882094324
1553,2936850541,79038320,1.0670173200000002e-11,11731,1025456,883119780
1554,2783598834,79038320,1.0670173200000002e-11,11731,1025456,884145236
1555,2144179917,79038320,1.0670173200000002e-11,11731,1025456,885170692
1556,2048678584,79180276,1.068933726e-11,11731,1025456,886196148
1557,2078019959,79038321,1.0670173334999999e-11,11752,1025456,887221604
1558,2072566792,79038321,1.0670173334999999e-11,11752,1025456,888247060
1559,2120682875,79038321,1.0670173334999999e-11,11752,1025456,889272516
1560,2046174291,79038321,1.0670173334999999e-11,11752,1025456,890297972
1561,2087045375,79180275,1.0689337124999999e-11,11689,1025456,891323428
1562,2048060875,79038721,1.0670227335e-11,24767,1025904,892349332
1563,2075341250,79038320,1.0670173200000002e-11,11731,1025456,893374788
1564,2058518208,79038320,1.0670173200000002e-11,11731,1025456,894400244
1565,2091807583,79180277,1.0689337395e-11,11752,1025456,895425700
1566,2068024334,79038321,1.0670173334999999e-11,11752,1025456,896451156
1567,2076078833,79038321,1.0670173334999999e-11,11752,1025456,897476612
1568,2059598625,79038321,1.0670173334999999e-11,11752,1025456,898502068
1569,2091607833,79038321,1.0670173334999999e-11,11752,1025456,899527524
1570,2055623250,79180277,1.0689337395e-11,11752,1025456,900552980
1571,2099349458,79038319,1.0670173065e-11,11689,1025456,901578436
1572,2068550750,79038319,1.0670173065e-11,11710,1025456,902603892
1573,2789347000,79038319,1.0670173065e-11,11710,1025456,903629348
1574,4024020667,79180276,1.068933726e-11,11731,1025456,904654804
1575,2584680292,79038320,1.0670173200000002e-11,11731,1025456,905680260
1576,2231297583,79038320,1.0670173200000002e-11,11731,1025456,906705716
1577,2225135250,79180276,1.068933726e-11,11731,1025456,907731172
1578,2067781458,79038321,1.0670173334999999e-11,11752,1025456,908756628
1579,2068436042,79038719,1.0670227065e-11,24698,1025904,909782532
1580,2055992666,79038321,1.0670173334999999e-11,11773,1025456,910807988
1581,2069656125,79038319,1.0670173065e-11,11689,1025456,911833444
1582,2053591500,79180275,1.0689337124999999e-11,11710,1025456,912858900
1583,2055054958,79038320,1.0670173200000002e-11,11731,1025456,913884356
1584,2069692042,79038320,1.0670173200000002e-11,11731,1025456,914909812
1585,2060822959,79038320,1.0670173200000002e-11,11731,1025456,915935268
1586,2058221459,79038321,1.0670173334999999e-11,11752,1025456,916960724
1587,2050431208,79180277,1.0689337395e-11,11752,1025456,917986180
1588,2044618167,79038321,1.0670173334999999e-11,11752,1025456,919011636
1589,2052070000,79038321,1.0670173334999999e-11,11752,1025456,920037092
1590,2048231875,79038321,1.0670173334999999e-11,11752,1025456,921062548
1591,2056901917,79038319,1.0670173065e-11,11689,1025456,922088004
1592,2359286875,79180275,1.0689337124999999e-11,11710,1025456,923113460
1593,2260261750,79038319,1.0670173065e-11,11710,1025456,924138916
1594,2476961542,79038320,1.0670173200000002e-11,11731,1025456,925164372
1595,2111468208,79038320,1.0670173200000002e-11,11731,1025456,926189828
1596,2547523709,79180670,1.068939045e-11,24545,1025904,927215732
1597,2351240583,79038321,1.0670173334999999e-11,11752,1025456,928241188
1598,2056025625,79038321,1.0670173334999999e-11,11752,1025456,929266644
1599,2050895667,79038321,1.0670173334999999e-11,11752,1025456,930292100
1600,2057403625,79180277,1.0689337395e-11,11773,1025456,931317556
1601,2058943000,79038315,1.0670172525e-11,11563,1025456,932343012
1602,2056632208,79038316,1.067017266e-11,11605,1025456,933368468
1603,2048608208,79038317,1.0670172795e-11,11647,1025456,934393924
1604,2050562917,79038317,1.0670172795e-11,11647,1025456,935419380
1605,2052253667,79180273,1.0689336854999999e-11,11647,1025456,936444836
1606,2053435375,79038317,1.0670172795e-11,11647,1025456,937470292
1607,2050567292,79038319,1.0670173065e-11,11689,1025456,938495748
1608,2049832917,79038319,1.0670173065e-11,11689,1025456,939521204
1609,2049343667,79038319,1.0670173065e-11,11689,1025456,940546660
1610,2052015125,79180275,1.0689337124999999e-11,11689,1025456,941572116
1611,2051148334,79038317,1.0670172795e-11,11626,1025456,942597572
1612,2050955375,79038317,1.0670172795e-11,11647,1025456,943623028
1613,2051911917,79038708,1.067022558e-11,24329,1025904,944648932
1614,2050267750,79180275,1.0689337124999999e-11,11689,1025456,945674388
1615,2049889708,79038319,1.0670173065e-11,11710,1025456,946699844
1616,2049508625,79038319,1.0670173065e-11,11710,1025456,947725300
1617,2360504458,79038319,1.0670173065e-11,11710,1025456,948750756
1618,2398337000,79038319,1.0670173065e-11,11710,1025456,949776212
1619,2776808416,79180275,1.0689337124999999e-11,11710,1025456,950801668
1620,3529691875,79038319,1.0670173065e-11,11710,1025456,951827124
1621,3129545584,79038317,1.0670172795e-11,11647,1025456,952852580
1622,3625237583,79180274,1.0689336990000001e-11,11668,1025456,953878036
1623,2067944625,79038318,1.0670172929999999e-11,11668,1025456,954903492
1624,2065267291,79038319,1.0670173065e-11,11689,1025456,955928948
1625,2090918833,79038319,1.0670173065e-11,11689,1025456,956954404
1626,2058124208,79180275,1.0689337124999999e-11,11689,1025456,957979860
1627,2147103667,79038319,1.0670173065e-11,11689,1025456,959005316
1628,2050335792,79038319,1.0670173065e-11,11710,1025456,960030772
1629,2105392916,79038319,1.0670173065e-11,11710,1025456,961056228
1630,2050904000,79180661,1.0689389235e-11,24260,1025904,962082132
1631,2096034083,79038318,1.0670172929999999e-11,11668,1025456,963107588
1632,2053559209,79038319,1.0670173065e-11,11689,1025456,964133044
1633,2099287291,79038319,1.0670173065e-11,11710,1025456,965158500
1634,2059067583,79038319,1.0670173065e-11,11710,1025456,966183956
1635,2100753083,79180275,1.0689337124999999e-11,11710,1025456,967209412
1636,2294794958,79038320,1.0670173200000002e-11,11731,1025456,968234868
1637,2862715791,79038320,1.0670173200000002e-11,11731,1025456,969260324
1638,2288633709,79038320,1.0670173200000002e-11,11731,1025456,970285780
1639,2413050167,79180276,1.068933726e-11,11731,1025456,971311236
1640,3342899167,79038320,1.0670173200000002e-11,11731,1025456,972336692
1641,2819033583,79038318,1.0670172929999999e-11,11668,1025456,973362148
1642,2178083792,79180275,1.0689337124999999e-11,11689,1025456,974387604
1643,2056332708,79038319,1.0670173065e-11,11689,1025456,975413060
1644,2063360958,79038319,1.0670173065e-11,11710,1025456,976438516
1645,2062826792,79038319,1.0670173065e-11,11710,1025456,977463972
1646,2060172000,79038319,1.0670173065e-11,11710,1025456,978489428
1647,2052211583,79180657,1.0689388695e-11,24128,1025904,979515332
1648,2058668333,79038320,1.0670173200000002e-11,11731,1025456,980540788
1649,2057319834,79038321,1.0670173334999999e-11,11752,1025456,981566244
1650,2061463250,79038321,1.0670173334999999e-11,11752,1025456,982591700
1651,2071723375,79038318,1.0670172929999999e-11,11668,1025456,983617156
1652,2049775583,79180275,1.0689337124999999e-11,11689,1025456,984642612
1653,2050434500,79038319,1.0670173065e-11,11710,1025456,985668068
1654,2050630250,79038319,1.0670173065e-11,11710,1025456,986693524
1655,2050923291,79038319,1.0670173065e-11,11710,1025456,987718980
1656,2050750250,79038319,1.0670173065e-11,11710,1025456,988744436
1657,2049665500,79180276,1.068933726e-11,11731,1025456,989769892
1658,2050851541,79038320,1.0670173200000002e-11,11731,1025456,990795348
1659,2050257417,79038320,1.0670173200000002e-11,11731,1025456,991820804
1660,2050639917,79038320,1.0670173200000002e-11,11731,1025456,992846260
1661,2050059167,79038318,1.0670172929999999e-11,11668,1025456,993871716
1662,2051460250,79180275,1.0689337124999999e-11,11689,1025456,994897172
1663,2194229959,79038319,1.0670173065e-11,11689,1025456,995922628
1664,2626064250,79038697,1.0670224094999999e-11,23975,1025904,996948532
1665,2265076625,79038321,1.0670173334999999e-11,11752,1025456,997973988
1666,2625854334,79180277,1.0689337395e-11,11752,1025456,998999444
1667,3052107709,79038321,1.0670173334999999e-11,11752,1025456,1000024900
1668,2333618916,79038321,1.0670173334999999e-11,11752,1025456,1001050356
1669,2050320750,79180277,1.0689337395e-11,11752,1025456,1002075812
1670,2049989125,79038321,1.0670173334999999e-11,11752,1025456,1003101268
1671,2051392125,79038319,1.0670173065e-11,11689,1025456,1004126724
1672,2049322583,79038319,1.0670173065e-11,11710,1025456,1005152180
1673,2057041958,79038319,1.0670173065e-11,11710,1025456,1006177636
1674,2049730834,79180276,1.068933726e-11,11731,1025456,1007203092
1675,2061570292,79038320,1.0670173200000002e-11,11731,1025456,1008228548
1676,2068744708,79038320,1.0670173200000002e-11,11731,1025456,1009254004
1677,2060738625,79038320,1.0670173200000002e-11,11731,1025456,1010279460
1678,2057792583,79038321,1.0670173334999999e-11,11752,1025456,1011304916
1679,2048625792,79180277,1.0689337395e-11,11752,1025456,1012330372
1680,2059349459,79038321,1.0670173334999999e-11,11752,1025456,1013355828
1681,2053128333,79038692,1.067022342e-11,23822,1025904,1014381732
1682,2055414791,79038319,1.0670173065e-11,11710,1025456,1015407188
1683,2060943042,79038320,1.0670173200000002e-11,11731,1025456,1016432644
1684,2359285583,79180276,1.068933726e-11,11731,1025456,1017458100
1685,2711184375,79038321,1.0670173334999999e-11,11752,1025456,1018483556
1686,3725006000,79038321,1.0670173334999999e-11,11752,1025456,1019509012
1687,2754131750,79180277,1.0689337395e-11,11752,1025456,1020534468
1688,2802628417,79038321,1.0670173334999999e-11,11752,1025456,1021559924
1689,2124875000,79038321,1.0670173334999999e-11,11752,1025456,1022585380
1690,2049278333,79038321,1.0670173334999999e-11,11752,1025456,1023610836
1691,2104678625,79180275,1.0689337124999999e-11,11689,1025456,1024636292
1692,2058018625,79038319,1.0670173065e-11,11710,1025456,1025661748
1693,2106830000,79038319,1.0670173065e-11,11710,1025456,1026687204
1694,2077878083,79038320,1.0670173200000002e-11,11731,1025456,1027712660
1695,2089743542,79038320,1.0670173200000002e-11,11731,1025456,1028738116
1696,2080970333,79180276,1.068933726e-11,11731,1025456,1029763572
1697,2105678375,79038320,1.0670173200000002e-11,11731,1025456,1030789028
1698,2087696667,79038690,1.067022315e-11,23753,1025904,1031814932
1699,2131390625,79038336,1.067017536e-11,12257,1025456,1032840388
1700,2041102083,79180292,1.0689339420000002e-11,12257,1025456,1033865844
1701,2094177458,79038329,1.0670174415e-11,12026,1025456,1034891300
1702,2057669084,79038330,1.0670174550000001e-11,12068,1025456,1035916756
1703,2223530542,79038332,1.067017482e-11,12110,1025456,1036942212
1704,2416498625,79038332,1.067017482e-11,12110,1025456,1037967668
1705,3535249292,79180288,1.068933888e-11,12110,1025456,1038993124
1706,3838154125,79038333,1.0670174955e-11,12152,1025456,1040018580
1707,2519243834,79038333,1.0670174955e-11,12152,1025456,1041044036
1708,3825443792,79180289,1.0689339015e-11,12152,1025456,1042069492
1709,2048400542,79038333,1.0670174955e-11,12152,1025456,1043094948
1710,2053148875,79038333,1.0670174955e-11,12152,1025456,1044120404
1711,2050202041,79038331,1.0670174685e-11,12089,1025456,1045145860
1712,2051831250,79180288,1.068933888e-11,12110,1025456,1046171316
1713,2074944791,79038332,1.067017482e-11,12110,1025456,1047196772
1714,2078937958,79038332,1.067017482e-11,12131,1025456,1048222228
1715,2087903000,79039573,1.0670342355e-11,52461,1026708,1049248936
1716,2057160458,79180275,1.0689337124999999e-11,11710,1025456,1050274392
1717,2097196792,79038319,1.0670173065e-11,11710,1025456,1051299848
1718,2059961458,79038319,1.0670173065e-11,11710,1025456,1052325304
1719,2103428041,79038319,1.0670173065e-11,11710,1025456,1053350760
1720,2055772750,79038319,1.0670173065e-11,11710,1025456,1054376216
1721,2097208959,79180273,1.0689336854999999e-11,11647,1025456,1055401672
1722,2074649500,79038318,1.0670172929999999e-11,11668,1025456,1056427128
1723,2219203916,79038319,1.0670173065e-11,11689,1025456,1057452584
1724,4052212250,79038319,1.0670173065e-11,11689,1025456,1058478040
1725,3584909375,79180275,1.0689337124999999e-11,11689,1025456,1059503496
1726,3697072125,79038319,1.0670173065e-11,11689,1025456,1060528952
1727,3299622541,79180275,1.0689337124999999e-11,11710,1025456,1061554408
1728,2264889875,79038319,1.0670173065e-11,11710,1025456,1062579864
1729,40966328500,171800968,2.319313068e-11,11710,-177109676,885470188
1730,2049950417,79038319,1.0670173065e-11,11710,1025456,886495644
1731,2065826667,79215876,1.0694143260000001e-11,11647,1025456,887521100
1732,2051416541,79038748,1.067023098e-11,25649,1025904,888547004
1733,2049727875,79038319,1.0670173065e-11,11710,1025456,889572460
1734,2048717583,79038319,1.0670173065e-11,11710,1025456,890597916
1735,2049198333,79038320,1.0670173200000002e-11,11731,1025456,891623372
1736,2071330417,79215879,1.0694143665000001e-11,11731,1025456,892648828
1737,2072699667,79038320,1.0670173200000002e-11,11731,1025456,893674284
1738,2059375000,79038320,1.0670173200000002e-11,11731,1025456,894699740
1739,2074501000,79038320,1.0670173200000002e-11,11731,1025456,895725196
1740,2222092208,79038320,1.0670173200000002e-11,11731,1025456,896750652
1741,2365165791,79215877,1.0694143394999998e-11,11668,1025456,897776108
1742,2445465750,79038319,1.0670173065e-11,11689,1025456,898801564
1743,2442145916,79038319,1.0670173065e-11,11689,1025456,899827020
1744,2141777625,79038319,1.0670173065e-11,11710,1025456,900852476
1745,2557974208,79215878,1.069414353e-11,11710,1025456,901877932
1746,2348411042,79038319,1.0670173065e-11,11710,1025456,902903388
1747,2050167084,79038319,1.0670173065e-11,11710,1025456,903928844
1748,2050516666,79038320,1.0670173200000002e-11,11731,1025456,904954300
1749,2063732917,79216306,1.069420131e-11,25601,1025904,905980204
1750,2050391958,79038321,1.0670173334999999e-11,11773,1025456,907005660
1751,2049887709,79038319,1.0670173065e-11,11689,1025456,908031116
1752,2050449250,79038319,1.0670173065e-11,11710,1025456,909056572
1753,2050236625,79038320,1.0670173200000002e-11,11731,1025456,910082028
1754,2051128250,79215879,1.0694143665000001e-11,11731,1025456,911107484
1755,2050363000,79038320,1.0670173200000002e-11,11731,1025456,912132940
1756,2051500459,79038321,1.0670173334999999e-11,11752,1025456,913158396
1757,2050469583,79038321,1.0670173334999999e-11,11752,1025456,914183852
1758,2050000125,79038321,1.0670173334999999e-11,11752,1025456,915209308
1759,2050289542,79215880,1.06941438e-11,11752,1025456,916234764
1760,2050115750,79038321,1.0670173334999999e-11,11752,1025456,917260220
1761,2049594959,79038319,1.0670173065e-11,11689,1025456,918285676
1762,2049568583,79038319,1.0670173065e-11,11710,1025456,919311132
1763,2049863500,79215878,1.069414353e-11,11710,1025456,920336588
1764,2048991583,79038320,1.0670173200000002e-11,11731,1025456,921362044
1765,2050262125,79038320,1.0670173200000002e-11,11731,1025456,922387500
1766,2049419833,79038743,1.0670230304999999e-11,25469,1025904,923413404
1767,2051086791,79038321,1.0670173334999999e-11,11752,1025456,924438860
1768,2051353583,79215880,1.06941438e-11,11752,1025456,925464316
1769,2050679292,79038321,1.0670173334999999e-11,11752,1025456,926489772
1770,2050503500,79038321,1.0670173334999999e-11,11773,1025456,927515228
1771,2243432125,79038319,1.0670173065e-11,11689,1025456,928540684
1772,2544027417,79038319,1.0670173065e-11,11710,1025456,929566140
1773,2612847709,79215879,1.0694143665000001e-11,11731,1025456,930591596
1774,2562711750,79038320,1.0670173200000002e-11,11731,1025456,931617052
1775,2216364625,79038320,1.0670173200000002e-11,11731,1025456,932642508
1776,2530471375,79215879,1.0694143665000001e-11,11731,1025456,933667964
1777,2299447041,79038321,1.0670173334999999e-11,11752,1025456,934693420
1778,2075837125,79038321,1.0670173334999999e-11,11752,1025456,935718876
1779,2067147000,79038321,1.0670173334999999e-11,11752,1025456,936744332
1780,2063042500,79038321,1.0670173334999999e-11,11752,1025456,937769788
1781,2052137125,79215878,1.069414353e-11,11689,1025456,938795244
1782,2050001458,79038319,1.0670173065e-11,11710,1025456,939820700
1783,2057329333,79038738,1.067022963e-11,25316,1025904,940846604
1784,2054923250,79038320,1.0670173200000002e-11,11731,1025456,941872060
1785,2050423125,79038321,1.0670173334999999e-11,11752,1025456,942897516
1786,2053397667,79215880,1.06941438e-11,11752,1025456,943922972
1787,2051820917,79038321,1.0670173334999999e-11,11752,1025456,944948428
1788,2056423708,79038321,1.0670173334999999e-11,11752,1025456,945973884
1789,2053922792,79038321,1.0670173334999999e-11,11752,1025456,946999340
1790,2062093417,79215880,1.06941438e-11,11752,1025456,948024796
1791,2057977042,79038319,1.0670173065e-11,11689,1025456,949050252
1792,2056117583,79038319,1.0670173065e-11,11710,1025456,950075708
1793,2754137667,79038319,1.0670173065e-11,11710,1025456,951101164
1794,2307505709,79038320,1.0670173200000002e-11,11731,1025456,952126620
1795,2959315584,79215879,1.0694143665000001e-11,11731,1025456,953152076
1796,2184974958,79038320,1.0670173200000002e-11,11731,1025456,954177532
1797,2960783291,79038320,1.0670173200000002e-11,11731,1025456,955202988
1798,2619708500,79233636,1.069654086e-11,11752,1025456,956228444
1799,2050055750,79038321,1.0670173334999999e-11,11752,1025456,957253900
1800,2050550417,79038735,1.0670229225e-11,25226,1025904,958279804
1801,2050332583,79038315,1.0670172525e-11,11563,1025456,959305260
1802,33363925750,79642017,1.0751672295e-11,11605,1025456,960330716
1803,2051688542,79038317,1.0670172795e-11,11647,1025456,961356172
1804,2051384917,79038317,1.0670172795e-11,11647,1025456,962381628
1805,2051978083,79215876,1.0694143260000001e-11,11647,1025456,963407084
1806,2050152292,79038319,1.0670173065e-11,11689,1025456,964432540
1807,2055129875,79038319,1.0670173065e-11,11689,1025456,965457996
1808,2062209083,79038319,1.0670173065e-11,11689,1025456,966483452
1809,2092688208,79038319,1.0670173065e-11,11689,1025456,967508908
1810,2072781166,79215878,1.069414353e-11,11689,1025456,968534364
1811,2078867250,79038317,1.0670172795e-11,11626,1025456,969559820
1812,2059006583,79038317,1.0670172795e-11,11647,1025456,970585276
1813,2122174542,79038317,1.0670172795e-11,11647,1025456,971610732
1814,2056395667,79215877,1.0694143394999998e-11,11668,1025456,972636188
1815,2090250709,79038318,1.0670172929999999e-11,11668,1025456,973661644
1816,2121887542,79038319,1.0670173065e-11,11689,1025456,974687100
1817,2961375917,79038729,1.0670228415000001e-11,25031,1025904,975713004
1818,2624411541,79038320,1.0670173200000002e-11,11731,1025456,976738460
1819,3003455541,79038321,1.0670173334999999e-11,11752,1025456,977763916
1820,3844593500,79038321,1.0670173334999999e-11,11752,1025456,978789372
1821,2472781584,79215877,1.0694143394999998e-11,11668,1025456,979814828
1822,2593281542,79038319,1.0670173065e-11,11689,1025456,980840284
1823,2069449875,79038319,1.0670173065e-11,11710,1025456,981865740
1824,2050216292,79038319,1.0670173065e-11,11710,1025456,982891196
1825,2054133875,79038319,1.0670173065e-11,11710,1025456,983916652
1826,2061179125,79215878,1.069414353e-11,11710,1025456,984942108
1827,2053393125,79038320,1.0670173200000002e-11,11731,1025456,985967564
1828,2050117167,79038320,1.0670173200000002e-11,11731,1025456,986993020
1829,2054903208,79038320,1.0670173200000002e-11,11731,1025456,988018476
1830,2053881542,79038320,1.0670173200000002e-11,11731,1025456,989043932
1831,2049756417,79215877,1.0694143394999998e-11,11668,1025456,990069388
1832,2049636541,79038319,1.0670173065e-11,11689,1025456,991094844
1833,2050719375,79038319,1.0670173065e-11,11689,1025456,992120300
1834,2048518584,79038725,1.0670227874999999e-11,24899,1025904,993146204
1835,2049622167,79215880,1.06941438e-11,11752,1025456,994171660
1836,2070402250,79038321,1.0670173334999999e-11,11752,1025456,995197116
1837,2056119250,79038321,1.0670173334999999e-11,11752,1025456,996222572
1838,2184556000,79038321,1.0670173334999999e-11,11752,1025456,997248028
1839,2389881375,79038321,1.0670173334999999e-11,11752,1025456,998273484
1840,2578955042,79215880,1.06941438e-11,11752,1025456,999298940
1841,3213042250,79038319,1.0670173065e-11,11689,1025456,1000324396
1842,2713320750,79038319,1.0670173065e-11,11710,1025456,1001349852
1843,2338344459,79215878,1.069414353e-11,11710,1025456,1002375308
1844,2063780292,79038320,1.0670173200000002e-11,11731,1025456,1003400764
1845,2049322625,79038320,1.0670173200000002e-11,11731,1025456,1004426220
1846,2049578250,79038320,1.0670173200000002e-11,11731,1025456,1005451676
1847,2059191791,79038320,1.0670173200000002e-11,11731,1025456,1006477132
1848,2049950708,79215880,1.06941438e-11,11752,1025456,1007502588
1849,2050444042,79038321,1.0670173334999999e-11,11752,1025456,1008528044
1850,2050917583,79038321,1.0670173334999999e-11,11752,1025456,1009553500
1851,2051055166,79038721,1.0670227335e-11,24746,1025904,1010579404
1852,2051539000,79038319,1.0670173065e-11,11710,1025456,1011604860
1853,2049904166,79215879,1.0694143665000001e-11,11731,1025456,1012630316
1854,2051128416,79038320,1.0670173200000002e-11,11731,1025456,1013655772
1855,2050567875,79038321,1.0670173334999999e-11,11752,1025456,1014681228
1856,2050612583,79038321,1.0670173334999999e-11,11752,1025456,1015706684
1857,2050667833,79038321,1.0670173334999999e-11,11752,1025456,1016732140
1858,2051003459,79215880,1.06941438e-11,11752,1025456,1017757596
1859,2050747000,79038321,1.0670173334999999e-11,11752,1025456,1018783052
1860,2050573667,79038321,1.0670173334999999e-11,11752,1025456,1019808508
1861,2049695333,79038319,1.0670173065e-11,11689,1025456,1020833964
1862,2050261250,79038319,1.0670173065e-11,11710,1025456,1021859420
1863,2081740500,79215878,1.069414353e-11,11710,1025456,1022884876
1864,2482437334,79038320,1.0670173200000002e-11,11731,1025456,1023910332
1865,2936658166,79038320,1.0670173200000002e-11,11731,1025456,1024935788
1866,4038528541,79215879,1.0694143665000001e-11,11731,1025456,1025961244
1867,2653771208,79038320,1.0670173200000002e-11,11731,1025456,1026986700
1868,3518277417,79216277,1.0694197394999999e-11,24677,1025904,1028012604
1869,2050136167,79038321,1.0670173334999999e-11,11773,1025456,1029038060
1870,2050598459,79038321,1.0670173334999999e-11,11773,1025456,1030063516
1871,2054485375,79038319,1.0670173065e-11,11689,1025456,1031088972
1872,2053743959,79038319,1.0670173065e-11,11710,1025456,1032114428
1873,2049457583,79215879,1.0694143665000001e-11,11731,1025456,1033139884
1874,2058810000,79038320,1.0670173200000002e-11,11731,1025456,1034165340
1875,2052688209,79038320,1.0670173200000002e-11,11731,1025456,1035190796
1876,2049511959,79038321,1.0670173334999999e-11,11752,1025456,1036216252
1877,2050391375,79038321,1.0670173334999999e-11,11752,1025456,1037241708
1878,2059081375,79215880,1.06941438e-11,11752,1025456,1038267164
1879,2120767375,79038321,1.0670173334999999e-11,11752,1025456,1039292620
1880,2064029834,79038321,1.0670173334999999e-11,11752,1025456,1040318076
1881,2097830416,79038319,1.0670173065e-11,11689,1025456,1041343532
1882,2085621000,79038319,1.0670173065e-11,11710,1025456,1042368988
1883,3078009458,79215878,1.069414353e-11,11710,1025456,1043394444
1884,4141871417,79038320,1.0670173200000002e-11,11731,1025456,1044419900
1885,2991630792,79038714,1.067022639e-11,24545,1025904,1045445804
1886,3381490834,79233636,1.069654086e-11,11752,1025456,1046471260
1887,2466463333,79038321,1.0670173334999999e-11,11752,1025456,1047496716
1888,2618160708,79038321,1.0670173334999999e-11,11752,1025456,1048522172
1889,2055068709,79215880,1.06941438e-11,11752,1025456,1049547628
1890,2051921041,79038321,1.0670173334999999e-11,11752,1025456,1050573084
1891,2048966334,79038319,1.0670173065e-11,11689,1025456,1051598540
1892,2065830792,79038319,1.0670173065e-11,11710,1025456,1052623996
1893,2049771666,79038320,1.0670173200000002e-11,11731,1025456,1053649452
1894,2054252291,79215879,1.0694143665000001e-11,11731,1025456,1054674908
1895,2050536833,79038320,1.0670173200000002e-11,11731,1025456,1055700364
1896,2051229709,79038320,1.0670173200000002e-11,11731,1025456,1056725820
1897,2065300209,79038321,1.0670173334999999e-11,11752,1025456,1057751276
1898,2053670292,79038321,1.0670173334999999e-11,11752,1025456,1058776732
1899,2049410417,79215880,1.06941438e-11,11752,1025456,1059802188
1900,2047703667,79038321,1.0670173334999999e-11,11752,1025456,1060827644
1901,2068003417,79038315,1.0670172525e-11,11563,1025456,1061853100
1902,2065289000,79038705,1.0670225174999999e-11,24245,1025904,1062879004
1903,2075944083,79038317,1.0670172795e-11,11647,1025456,1063904460
1904,2057140125,79215876,1.0694143260000001e-11,11647,1025456,1064929916
1905,2099742458,79038319,1.0670173065e-11,11689,1025456,1065955372
1906,2048175833,79038319,1.0670173065e-11,11689,1025456,1066980828
1907,2075494750,79038319,1.0670173065e-11,11689,1025456,1068006284
1908,2059156667,79038319,1.0670173065e-11,11689,1025456,1069031740
1909,2090540334,79215878,1.069414353e-11,11689,1025456,1070057196
1910,2061975666,79038319,1.0670173065e-11,11689,1025456,1071082652
1911,2082893750,79038317,1.0670172795e-11,11626,1025456,1072108108
1912,3461524000,79215876,1.0694143260000001e-11,11647,1025456,1073133564
1913,2834719208,79038318,1.0670172929999999e-11,11661,1025456,1074159020
1914,2274313417,79038319,1.0670173065e-11,11703,1025456,1075184476
1915,2887604250,79038319,1.0670173065e-11,11703,1025456,1076209932
1916,4121929958,79215878,1.069414353e-11,11703,1025456,1077235388
1917,2063534500,79038319,1.0670173065e-11,11703,1025456,1078260844
1918,2051064125,79038320,1.0670173200000002e-11,11724,1025456,1079286300
1919,2054331708,79038706,1.0670225310000001e-11,24274,1025904,1080312204
1920,2059614458,79215880,1.06941438e-11,11766,1025456,1081337660
1921,2051183125,79038318,1.0670172929999999e-11,11682,1025456,1082363116
1922,2043830542,79038319,1.0670173065e-11,11703,1025456,1083388572
1923,2051692292,79038320,1.0670173200000002e-11,11724,1025456,1084414028
1924,2061055625,79038320,1.0670173200000002e-11,11724,1025456,1085439484
1925,2057690625,79215879,1.0694143665000001e-11,11724,1025456,1086464940
1926,2050626583,79038321,1.0670173334999999e-11,11745,1025456,1087490396
1927,2052052750,79038321,1.0670173334999999e-11,11745,1025456,1088515852
1928,2054773083,79038321,1.0670173334999999e-11,11745,1025456,1089541308
1929,2051769083,79038321,1.0670173334999999e-11,11745,1025456,1090566764
1930,2047149833,79038321,1.0670173334999999e-11,11745,1025456,1091592220
1931,2651351042,79038318,1.0670172929999999e-11,11682,1025456,1092617676
1932,2449625625,79038319,1.0670173065e-11,11703,1025456,1093643132
1933,2426560458,79038319,1.0670173065e-11,11703,1025456,1094668588
1934,2252299375,79215879,1.0694143665000001e-11,11724,1025456,1095694044
1935,2324907291,79038320,1.0670173200000002e-11,11724,1025456,1096719500
1936,2430771667,79038702,1.0670224769999999e-11,24142,1025904,1097745404
1937,3617569208,79215880,1.06941438e-11,11745,1025456,1098770860
1938,2058956209,79038321,1.0670173334999999e-11,11745,1025456,1099796316
1939,2065072334,79038321,1.0670173334999999e-11,11745,1025456,1100821772
1940,2062125208,79038321,1.0670173334999999e-11,11766,1025456,1101847228
1941,2053481500,79215877,1.0694143394999998e-11,11682,1025456,1102872684
1942,2053047875,79038319,1.0670173065e-11,11703,1025456,1103898140
1943,2049829083,79038320,1.0670173200000002e-11,11724,1025456,1104923596
1944,2076719875,79038320,1.0670173200000002e-11,11724,1025456,1105949052
1945,2049368250,79038320,1.0670173200000002e-11,11724,1025456,1106974508
1946,2052756917,79215879,1.0694143665000001e-11,11724,1025456,1107999964
1947,2050155875,79038321,1.0670173334999999e-11,11745,1025456,1109025420
1948,2050417542,79038321,1.0670173334999999e-11,11745,1025456,1110050876
1949,2050883334,79038321,1.0670173334999999e-11,11745,1025456,1111076332
1950,2049911292,79038321,1.0670173334999999e-11,11745,1025456,1112101788
1951,2050604958,79215877,1.0694143394999998e-11,11682,1025456,1113127244
1952,2042546833,79038319,1.0670173065e-11,11703,1025456,1114152700
1953,2051880375,79038697,1.0670224094999999e-11,23989,1025904,1115178604
1954,2052695417,79038321,1.0670173334999999e-11,11745,1025456,1116204060
1955,2049476958,79038321,1.0670173334999999e-11,11766,1025456,1117229516
1956,2050167500,79215880,1.06941438e-11,11766,1025456,1118254972
1957,2049356000,79038321,1.0670173334999999e-11,11766,1025456,1119280428
1958,2050115458,79038321,1.0670173334999999e-11,11766,1025456,1120305884
1959,2053475250,79038321,1.0670173334999999e-11,11766,1025456,1121331340
1960,3348967500,79215880,1.06941438e-11,11766,1025456,1122356796
1961,4022439459,79038319,1.0670173065e-11,11703,1025456,1123382252
1962,2613487625,79038320,1.0670173200000002e-11,11724,1025456,1124407708
1963,4049171042,79215879,1.0694143665000001e-11,11724,1025456,1125433164
1964,2349742542,79038321,1.0670173334999999e-11,11745,1025456,1126458620
1965,2051122167,79038321,1.0670173334999999e-11,11745,1025456,1127484076
1966,2049187500,79038321,1.0670173334999999e-11,11745,1025456,1128509532
1967,2060347167,79215880,1.06941438e-11,11745,1025456,1129534988
1968,2049816833,79038321,1.0670173334999999e-11,11766,1025456,1130560444
1969,2062608250,79038321,1.0670173334999999e-11,11766,1025456,1131585900
1970,2049875250,79038695,1.0670223825e-11,23920,1025904,1132611804
1971,2049338000,79038319,1.0670173065e-11,11703,1025456,1133637260
1972,2050952000,79215879,1.0694143665000001e-11,11724,1025456,1134662716
1973,2062291500,79038321,1.0670173334999999e-11,11745,1025456,1135688172
1974,2117127666,79038321,1.0670173334999999e-11,11745,1025456,1136713628
1975,2059930125,79038321,1.0670173334999999e-11,11745,1025456,1137739084
1976,2123550417,79215880,1.06941438e-11,11766,1025456,1138764540
1977,2056611833,79038321,1.0670173334999999e-11,11766,1025456,1139789996
1978,2100402292,79038321,1.0670173334999999e-11,11766,1025456,1140815452
1979,2517364833,79038321,1.0670173334999999e-11,11766,1025456,1141840908
1980,2546289083,79038321,1.0670173334999999e-11,11766,1025456,1142866364
1981,4223806250,79038319,1.0670173065e-11,11703,1025456,1143891820
1982,2443713875,79038320,1.0670173200000002e-11,11724,1025456,1144917276
1983,2267430583,79038320,1.0670173200000002e-11,11724,1025456,1145942732
1984,2550418750,79215880,1.06941438e-11,11745,1025456,1146968188
1985,2088908042,79038321,1.0670173334999999e-11,11745,1025456,1147993644
1986,2061215292,79038321,1.0670173334999999e-11,11745,1025456,1149019100
1987,2056678250,79038690,1.067022315e-11,23767,1025904,1150045004
1988,2101692458,79215895,1.0694145824999999e-11,12250,1025456,1151070460
1989,2062424709,79038337,1.0670175495e-11,12271,1025456,1152095916
1990,2113736625,79038337,1.0670175495e-11,12271,1025456,1153121372
1991,2057881458,79038334,1.067017509e-11,12187,1025456,1154146828
1992,2097737459,79215894,1.0694145690000001e-11,12208,1025456,1155172284
1993,2055809958,79038335,1.0670175225e-11,12229,1025456,1156197740
1994,2093845375,79038335,1.0670175225e-11,12229,1025456,1157223196
1995,2057137458,79038335,1.0670175225e-11,12229,1025456,1158248652
1996,2091456000,79038335,1.0670175225e-11,12229,1025456,1159274108
1997,2057135625,79215895,1.0694145824999999e-11,12250,1025456,1160299564
1998,2092150958,79038336,1.067017536e-11,12250,1025456,1161325020
1999,2059567000,79038336,1.067017536e-11,12250,1025456,1162350476
2000,2103935916,79038336,1.067017536e-11,12250,1025456,1163375932
2001,2059873750,79038323,1.0670173604999999e-11,11830,1025456,1164401388
2002,2090914833,79215884,1.069414434e-11,11893,1025456,1165426844
2003,2058732125,79038325,1.0670173875000001e-11,11893,1025456,1166452300
2004,2100627875,79039562,1.067034087e-11,52091,1026708,1167479008
2005,2033077542,79038315,1.0670172525e-11,11577,1025456,1168504464
2006,2094550417,79038315,1.0670172525e-11,11577,1025456,1169529920
2007,2155901166,79215874,1.0694142990000002e-11,11577,1025456,1170555376
2008,2824953916,79038315,1.0670172525e-11,11577,1025456,1171580832
2009,2183805916,79038315,1.0670172525e-11,11577,1025456,1172606288
2010,3120519792,79215874,1.0694142990000002e-11,11577,1025456,1173631744
2011,2598639125,79038313,1.0670172255e-11,11514,1025456,1174657200
2012,2159100167,79038315,1.0670172525e-11,11577,1025456,1175682656
2013,2723928708,79215874,1.0694142990000002e-11,11577,1025456,1176708112
2014,2065161250,79038316,1.067017266e-11,11598,1025456,1177733568
2015,2071022625,79038316,1.067017266e-11,11598,1025456,1178759024
2016,2058768500,79038316,1.067017266e-11,11598,1025456,1179784480
2017,2048493541,79038316,1.067017266e-11,11598,1025456,1180809936
2018,2060522667,79215876,1.0694143260000001e-11,11619,1025456,1181835392
2019,2074044416,79038317,1.0670172795e-11,11619,1025456,1182860848
2020,2078069750,79038317,1.0670172795e-11,11619,1025456,1183886304
2021,2073614709,79038745,1.0670230574999999e-11,25537,1025904,1184912208
2022,2056559791,79038317,1.0670172795e-11,11619,1025456,1185937664
2023,2048663792,79215876,1.0694143260000001e-11,11640,1025456,1186963120
2024,2059455417,79038317,1.0670172795e-11,11640,1025456,1187988576
2025,2049182292,79038318,1.0670172929999999e-11,11661,1025456,1189014032
2026,2052240583,79038318,1.0670172929999999e-11,11661,1025456,1190039488
2027,2053841625,79038318,1.0670172929999999e-11,11661,1025456,1191064944
2028,2113190167,79215877,1.0694143394999998e-11,11661,1025456,1192090400
2029,2915491666,79038318,1.0670172929999999e-11,11661,1025456,1193115856
2030,2505557709,79038318,1.0670172929999999e-11,11661,1025456,1194141312
2031,2129935834,79038316,1.067017266e-11,11598,1025456,1195166768
2032,2547054917,79215876,1.0694143260000001e-11,11619,1025456,1196192224
2033,2514185000,79038317,1.0670172795e-11,11619,1025456,1197217680
2034,2318366500,79038317,1.0670172795e-11,11640,1025456,1198243136
2035,2059036125,79038317,1.0670172795e-11,11640,1025456,1199268592
2036,2053879166,79215876,1.0694143260000001e-11,11640,1025456,1200294048
2037,2055063750,79038317,1.0670172795e-11,11640,1025456,1201319504
2038,2051897500,79038744,1.0670230440000001e-11,25510,1025904,1202345408
2039,2072100417,79038320,1.0670173200000002e-11,11724,1025456,1203370864
2040,2060038333,79038320,1.0670173200000002e-11,11724,1025456,1204396320
2041,2053491208,79215876,1.0694143260000001e-11,11640,1025456,1205421776
2042,2065938584,79038318,1.0670172929999999e-11,11661,1025456,1206447232
2043,2055224708,79038318,1.0670172929999999e-11,11682,1025456,1207472688
2044,2048555542,79038318,1.0670172929999999e-11,11682,1025456,1208498144
2045,2052438875,79215877,1.0694143394999998e-11,11682,1025456,1209523600
2046,2055532083,79038319,1.0670173065e-11,11703,1025456,1210549056
2047,2058219541,79038319,1.0670173065e-11,11703,1025456,1211574512
2048,2057390583,79038319,1.0670173065e-11,11703,1025456,1212599968
2049,2233377250,79038319,1.0670173065e-11,11703,1025456,1213625424
2050,2388542958,79215878,1.069414353e-11,11703,1025456,1214650880
2051,2569893917,79038317,1.0670172795e-11,11640,1025456,1215676336
2052,2434779750,79038318,1.0670172929999999e-11,11661,1025456,1216701792
2053,2156186042,79038318,1.0670172929999999e-11,11661,1025456,1217727248
2054,2366175583,79215877,1.0694143394999998e-11,11682,1025456,1218752704
2055,2442875500,79038741,1.0670230035e-11,25420,1025904,1219778608
2056,2057057417,79038319,1.0670173065e-11,11703,1025456,1220804064
2057,2055244791,79038319,1.0670173065e-11,11703,1025456,1221829520
2058,2054151667,79215878,1.069414353e-11,11703,1025456,1222854976
2059,2051294458,79038319,1.0670173065e-11,11703,1025456,1223880432
2060,2071154541,79038319,1.0670173065e-11,11703,1025456,1224905888
2061,2058593584,79038317,1.0670172795e-11,11640,1025456,1225931344
2062,2061748250,79038318,1.0670172929999999e-11,11661,1025456,1226956800
2063,2056104959,79215877,1.0694143394999998e-11,11682,1025456,1227982256
2064,2060700792,79038318,1.0670172929999999e-11,11682,1025456,1229007712
2065,2056782958,79038318,1.0670172929999999e-11,11682,1025456,1230033168
2066,2057951834,79038318,1.0670172929999999e-11,11682,1025456,1231058624
2067,2058462417,79038319,1.0670173065e-11,11703,1025456,1232084080
2068,2065122708,79215878,1.069414353e-11,11703,1025456,1233109536
2069,2085772958,79038319,1.0670173065e-11,11703,1025456,1234134992
2070,2363126208,79038319,1.0670173065e-11,11703,1025456,1235160448
2071,2534208459,79038317,1.0670172795e-11,11640,1025456,1236185904
2072,2382806959,79216295,1.0694199825e-11,25246,1025904,1237211808
2073,2193167833,79038318,1.0670172929999999e-11,11682,1025456,1238237264
2074,2317808292,79038318,1.0670172929999999e-11,11682,1025456,1239262720
2075,2341152500,79038319,1.0670173065e-11,11703,1025456,1240288176
2076,2083676667,79215878,1.069414353e-11,11703,1025456,1241313632
2077,2056801542,79038319,1.0670173065e-11,11703,1025456,1242339088
2078,2063220625,79038319,1.0670173065e-11,11703,1025456,1243364544
2079,2062691458,79038319,1.0670173065e-11,11703,1025456,1244390000
2080,2063826958,79038319,1.0670173065e-11,11703,1025456,1245415456
2081,2061328833,79215876,1.0694143260000001e-11,11640,1025456,1246440912
2082,2055279958,79038318,1.0670172929999999e-11,11661,1025456,1247466368
2083,2062320500,79038318,1.0670172929999999e-11,11661,1025456,1248491824
2084,2066860125,79038318,1.0670172929999999e-11,11682,1025456,1249517280
