Size,Time,Cycles,Price,Instructions,HeapSize,TotalHeapSize
50,2061153292,8222169,1.1099928150000001e-12,488060,129876,130972
100,2031756875,8235565,1.1118012749999999e-12,639498,133960,264932
150,2031826500,8235900,1.1118465000000002e-12,650374,134164,399096
200,2030323041,8237076,1.11200526e-12,688576,135148,534244
250,2048063667,8237930,1.11212055e-12,706962,135560,669804
300,2041431500,8237335,1.1120402250000001e-12,697006,135436,805240
350,2032346083,8238313,1.112172255e-12,728780,136264,941504
400,2145476875,8239076,1.11227526e-12,753576,136492,1077996
450,2115014875,8353151,1.1276753850000001e-12,755384,-541940,536056
500,2057446708,8238860,1.1122461e-12,746644,136540,672596
550,2279460083,8251128,1.11390228e-12,858934,137552,810148
600,2034712000,8251338,1.11393063e-12,865762,137996,948144
650,2037093709,8250317,1.113792795e-12,832557,137648,1085792
700,2044481292,8251764,1.11398814e-12,866912,139304,1225096
750,2032674750,8253965,1.114285275e-12,951152,141596,1366692
800,2033100500,8254304,1.11433104e-12,962146,141704,1508396
850,2034096833,8254107,1.1143044450000001e-12,955753,141752,1650148
900,2034494375,8253907,1.114277445e-12,949250,141704,1791852
950,2032194333,8495324,1.14686874e-12,962364,-660816,1131036
1000,2033141417,8254198,1.11431673e-12,958704,141728,1272764
1050,2035413875,8254907,1.114412445e-12,981743,142444,1415208
1100,2032318625,8253790,1.11426165e-12,945456,141384,1556592
1150,2032422167,8254149,1.114310115e-12,957122,142268,1698860
1200,2031929291,8254171,1.1143130850000002e-12,941252,141648,1840508
1250,2041078166,8253720,1.1142522e-12,943176,141704,1982212
1300,2063752958,8253647,1.114242345e-12,940806,141752,2123964
1350,2232432250,8254236,1.11432186e-12,959935,142220,2266184
1400,2292360417,8255897,1.114546095e-12,1013907,143272,2409456
1450,2018870625,8255537,1.114497495e-12,1002244,142712,2552168
1500,2051045875,8256372,1.11461022e-12,1029356,143540,2695708
1550,2037291708,8648021,1.167482835e-12,1009716,-850752,1844956
1600,2039450333,8253651,1.114242885e-12,940927,141164,1986120
1650,2040279250,8254750,1.1143912500000002e-12,955430,141488,2127608
1700,2036480209,8255667,1.1145150450000001e-12,1006446,142364,2269972
1750,2042538334,8254971,1.1144210850000001e-12,983836,142196,2412168
1800,2038345542,8254578,1.11436803e-12,971048,141800,2553968
1850,2053973833,8254667,1.1143800450000001e-12,973948,141800,2695768
1900,2039114792,8255841,1.114538535e-12,990869,142432,2838200
1950,2035046625,8253011,1.114156485e-12,920134,140544,2978744
2000,2035437375,8254853,1.114405155e-12,979994,141932,3120676
2050,2033629334,8254943,1.1144173050000001e-12,982931,142292,3262968
2100,2032959000,8255379,1.114476165e-12,997102,142292,3405260
2150,2047315084,8255901,1.114546635e-12,992828,142244,3547504
2200,2141830834,8254497,1.114357095e-12,968416,141728,3689232
2250,2230714041,8254352,1.11433752e-12,963725,141736,3830968
2300,2275886541,8835935,1.192851225e-12,944435,-1093212,2737756
2350,2309319167,8255335,1.114470225e-12,968438,141704,2879460
2400,2039776166,8255089,1.114437015e-12,987680,142140,3021600
2450,2030771083,8255201,1.114452135e-12,991306,142196,3163796
2500,2054784291,8255296,1.11446496e-12,994378,141776,3305572
2550,2038231667,8254882,1.11440907e-12,980930,141800,3447372
2600,2039427458,8255078,1.11443553e-12,960079,141952,3589324
2650,2035634750,8253866,1.11427191e-12,947926,142148,3731472
2700,2036047542,8254318,1.11433293e-12,962618,142076,3873548
2750,2041808958,8254000,1.1142899999999999e-12,952269,141728,4015276
2800,2038624500,8254609,1.114372215e-12,972052,142244,4157520
2850,2041966000,8254690,1.11438315e-12,947464,141776,4299296
2900,2033872125,8254722,1.11438747e-12,975738,142948,4442244
2950,2034912542,8255255,1.1144594250000002e-12,993046,142640,4584884
3000,2035485792,8255730,1.11452355e-12,1008504,143300,4728184
3050,2035349375,8257255,1.114729425e-12,1058048,142496,4870680
3100,2226883291,8256250,1.11459375e-12,998148,142904,5013584
3150,2232053166,8255262,1.11446037e-12,993292,142944,5156528
3200,3497872750,9065175,1.223798625e-12,995352,-1347844,3808684
3250,2056494625,8255320,1.1144682000000002e-12,995166,142808,3951492
3300,2055602208,8256564,1.1146361399999999e-12,1001185,142960,4094452
3350,2040540125,8254148,1.11430998e-12,957072,142196,4236648
3400,2038134875,8255426,1.11448251e-12,998625,142880,4379528
3450,2039234208,8256016,1.11456216e-12,1017802,143396,4522924
3500,2035291875,8255700,1.1145194999999999e-12,1007510,142928,4665852
3550,2040304083,8258341,1.114876035e-12,1058932,142952,4808804
3600,2038834959,8255985,1.1145579749999999e-12,1016770,143024,4951828
3650,2039091375,8255661,1.114514235e-12,1006253,143668,5095496
3700,2039337250,8255125,1.1144418750000001e-12,988838,142544,5238040
3750,2039170125,8255401,1.114479135e-12,997798,142976,5381016
3800,2031595792,8256707,1.114655445e-12,1005822,143024,5524040
3850,2036126708,8256194,1.1145861900000001e-12,1023590,143492,5667532
3900,2032341125,8255586,1.11450411e-12,1003822,143024,5810556
3950,2034416625,8255464,1.11448764e-12,999840,143048,5953604
4000,2162636708,8256450,1.11462075e-12,997474,143024,6096628
4050,2259759167,8256895,1.114680825e-12,1046364,143308,6239936
4100,2362566042,8254196,1.11431646e-12,958655,142040,6381976
4150,2042250250,8255536,1.11449736e-12,1002180,143024,6525000
4200,2047074708,8255797,1.1145325950000001e-12,1010668,143420,6668420
4250,2036779959,9332328,1.2598642800000001e-12,1010592,-1610728,5057692
4300,2035528542,8255754,1.11452679e-12,1009288,142952,5200644
4350,2033837334,8255548,1.11449898e-12,1002569,143516,5344160
4400,2034872042,8254772,1.11439422e-12,977373,143044,5487204
4450,2036507625,8255078,1.11443553e-12,987296,142208,5629412
4500,2054801417,8257544,1.1147684400000001e-12,1024913,143516,5772928
4550,2039008917,8256783,1.114665705e-12,1042718,142928,5915856
4600,2066146542,8253955,1.114283925e-12,950796,141824,6057680
4650,2034827083,8254209,1.1143182150000001e-12,959084,142364,6200044
4700,2035940458,8254880,1.1144088e-12,980872,142400,6342444
4750,2037526250,8256720,1.1146572e-12,998121,143152,6485596
4800,2038502292,8254433,1.114348455e-12,966364,142284,6627880
4850,2043056708,8254280,1.1143278000000001e-12,961378,141872,6769752
4900,2113952417,8254246,1.11432321e-12,960272,141992,6911744
4950,2235057375,8255981,1.114557435e-12,974108,142484,7054228
5000,2207662167,8254028,1.1142937799999999e-12,953176,141824,7196052
5050,2042037625,8264784,1.1157458400000001e-12,1090250,144060,7340112
5100,2045141750,8265039,1.115780265e-12,1098514,143888,7484000
5150,2040877459,8264374,1.11569049e-12,1076896,144296,7628296
5200,2053741584,8265944,1.11590244e-12,1085386,144312,7772608
5250,2041636041,8265040,1.1157804e-12,1098552,144716,7917324
5300,2048706667,8264354,1.1156877900000001e-12,1076242,144056,8061380
5350,2038873125,8264593,1.115720055e-12,1084023,144544,8205924
5400,2047912916,8264715,1.115736525e-12,1088010,144420,8350344
5450,2036097916,8266183,1.115934705e-12,1093162,144248,8494592
5500,2042479375,8264724,1.11573774e-12,1088292,144272,8638864
5550,2036106125,9670011,1.305451485e-12,1131944,-2034532,6604332
5600,2054218625,8264586,1.11571911e-12,1083794,144716,6749048
5650,2040211125,8264256,1.11567456e-12,1073084,144296,6893344
5700,2059331584,8266425,1.115967375e-12,1090573,144544,7037888
5750,2073530458,8264137,1.115658495e-12,1069194,144116,7182004
5800,2105738958,8262739,1.115469765e-12,1023788,142976,7324980
5850,2283880167,8264002,1.11564027e-12,1064804,144048,7469028
5900,2215379667,8266313,1.115952255e-12,1086910,144296,7613324
5950,2057596875,8264570,1.11571695e-12,1083288,144692,7758016
6000,2036407708,8264650,1.11572775e-12,1085872,144176,7902192
6050,2034325167,8266715,1.116006525e-12,1153002,145420,8047612
6100,2036863042,8263617,1.115588295e-12,1052298,143216,8190828
6150,2038093833,8266947,1.116037845e-12,1107512,144572,8335400
6200,2046755584,8265206,1.11580281e-12,1103931,144224,8479624
6250,2046900209,8265134,1.1157930900000001e-12,1101601,144200,8623824
6300,2051773792,8265230,1.11580605e-12,1104732,144716,8768540
6350,2040728208,8265323,1.115818605e-12,1107759,144224,8912764
6400,2038428542,8268058,1.1161878300000001e-12,1143621,145420,9058184
6450,2041034458,8263674,1.11559599e-12,1054152,143264,9201448
6500,2037862750,8265206,1.11580281e-12,1103936,144272,9345720
6550,2034383834,8265633,1.115860455e-12,1117836,144692,9490412
6600,2034590875,8265283,1.1158132050000001e-12,1106466,144176,9634588
6650,2040559833,8266124,1.11592674e-12,1080772,144644,9779232
6700,2135341417,8264200,1.115667e-12,1071252,144176,9923408
6750,2094874917,8265010,1.11577635e-12,1097581,145172,10068580
6800,2252799667,8262786,1.1154761099999999e-12,1025294,143144,10211724
6850,2266212875,8265725,1.115872875e-12,1067791,144164,10355888
6900,2042724791,8264345,1.1156865750000001e-12,1075958,144056,10499944
6950,2047203417,8264223,1.115670105e-12,1072008,144176,10644120
7000,2049757166,8264594,1.11572019e-12,1084064,144684,10788804
7050,2053640833,8265598,1.11585573e-12,1116702,144032,10932836
7100,2038213042,10062202,1.3583972700000001e-12,1072746,-2484280,8448556
7150,2043971000,8265250,1.11580875e-12,1105373,144724,8593280
7200,2040852833,8264268,1.11567618e-12,1073465,143312,8736592
7250,2052250500,8264114,1.11565539e-12,1068454,143456,8880048
7300,2038067625,8263978,1.11563703e-12,1064040,143900,9023948
7350,2042116042,8266364,1.11595914e-12,1076366,143948,9167896
7400,2055317083,8264186,1.1156651100000001e-12,1070784,143312,9311208
7450,2061493458,8266333,1.115954955e-12,1140584,145540,9456748
7500,2046955209,8265622,1.11585897e-12,1117455,144608,9601356
7550,2041763834,8265869,1.115892315e-12,1125493,144488,9745844
7600,2069090000,8267694,1.1161386899999999e-12,1119587,145244,9891088
7650,2409632500,8266626,1.11599451e-12,1150100,145472,10036560
7700,350894250,8266507,1.115978445e-12,1146248,145496,10182056
7750,2290775458,8266630,1.11599505e-12,1150214,145772,10327828
7800,2035155667,8266199,1.1159368650000001e-12,1136218,145472,10473300
7850,2035520458,8268493,1.1162465549999999e-12,1145570,145844,10619144
7900,2040472708,8266082,1.1159210700000001e-12,1132439,145576,10764720
7950,2035213917,8265186,1.1158001099999999e-12,1103320,144512,10909232
8000,2034497916,8265196,1.11580146e-12,1103626,144788,11054020
8050,2047071667,8265358,1.11582333e-12,1108902,144056,11198076
8100,2037461334,8267713,1.1161412549999999e-12,1120214,144812,11342888
8150,2041359625,8266622,1.11599397e-12,1149966,144992,11487880
8200,2034071375,8266265,1.115945775e-12,1138372,145376,11633256
8250,2049220500,8267029,1.1160489150000002e-12,1163190,145400,11778656
8300,2047603125,8266803,1.116018405e-12,1155864,145392,11924048
8350,2053418333,8268845,1.116294075e-12,1156972,145448,12069496
8400,2035856334,8266691,1.116003285e-12,1152216,145376,12214872
8450,2047204375,8265992,1.11590892e-12,1129503,145216,12360088
8500,2062394209,8265661,1.115864235e-12,1118728,144536,12504624
8550,2121420167,8266418,1.11596643e-12,1143331,145004,12649628
8600,2146088417,8267923,1.1161696049999999e-12,1127028,145400,12795028
8650,2257569417,8267061,1.116053235e-12,1164222,145916,12940944
8700,2037523208,8266002,1.11591027e-12,1129832,145376,13086320
8750,2045459625,8266339,1.1159557650000001e-12,1140770,145472,13231792
8800,2046661083,8268317,1.116222795e-12,1139841,145720,13377512
8850,2055867459,8265351,1.115822385e-12,1108672,144908,13522420
8900,2057186084,8266775,1.116014625e-12,1154932,145496,13667916
8950,2048704917,10530597,1.421630595e-12,1158076,-3018364,10649552
9000,2043311583,8266315,1.115952525e-12,1139986,145496,10795048
9050,2035273541,8269772,1.11641922e-12,1172590,145788,10940836
9100,2042113250,8266241,1.115942535e-12,1137574,145352,11086188
9150,2037976083,8267105,1.116059175e-12,1165651,146468,11232656
9200,2034428375,8266467,1.115973045e-12,1144942,145232,11377888
9250,2039198917,8264581,1.115718435e-12,1083636,144152,11522040
9300,2033275667,8269860,1.1164311000000002e-12,1175432,145724,11667764
9350,2032066459,8266537,1.115982495e-12,1147202,145448,11813212
9400,2038198958,8267275,1.116082125e-12,1171204,145892,11959104
9450,2130503834,8267679,1.116136665e-12,1184334,145844,12104948
9500,2122887334,8266878,1.11602853e-12,1158287,145720,12250668
9550,2129923750,8269094,1.11632769e-12,1150566,145460,12396128
9600,2117641125,8266987,1.116043245e-12,1161838,145884,12542012
9650,2053683209,8266591,1.115989785e-12,1148971,145424,12687436
9700,2037569958,8266267,1.115946045e-12,1138440,145328,12832764
9750,2038241208,8269312,1.11635712e-12,1157622,145940,12978704
9800,2038746542,8267662,1.11613437e-12,1183765,146732,13125436
9850,2049767750,8265095,1.115787825e-12,1100350,144248,13269684
9900,2044422250,8267462,1.11610737e-12,1177273,145812,13415496
9950,2037033458,8266262,1.11594537e-12,1138262,145280,13560776
10000,2042289875,8269159,1.116336465e-12,1152670,145472,13706248
10050,2050258250,8267018,1.11604743e-12,1162856,145916,13852164
10100,2038636042,8266050,1.1159167499999999e-12,1131398,145376,13997540
10150,2032669167,8267844,1.11615894e-12,1189691,147028,14144568
10200,2038521958,8265776,1.11587976e-12,1122464,145112,14289680
10250,2047842292,8268224,1.11621024e-12,1122284,145088,14434768
10300,2040840625,8266111,1.115924985e-12,1133354,145328,14580096
10350,2143900417,8266201,1.115937135e-12,1136280,145320,14725416
10400,2200030958,8266698,1.1160042300000002e-12,1152428,146036,14871452
10450,2262078833,8266352,1.11595752e-12,1141194,145916,15017368
10500,2098658625,8269886,1.11643461e-12,1176305,146692,15164060
10550,2038258875,8266544,1.11598344e-12,1147448,145136,15309196
10600,2036833667,8267166,1.1160674100000001e-12,1167651,145868,15455064
10650,2038428583,8266346,1.11595671e-12,1141000,145328,15600392
10700,2037267541,8268721,1.1162773350000001e-12,1138438,145448,15745840
10750,2034897167,8266340,1.1159559e-12,1140816,145424,15891264
10800,2038989792,8266134,1.11592809e-12,1134115,146044,16037308
10850,2034987209,8266472,1.11597372e-12,1145100,145352,16182660
10900,2044342792,8265985,1.1159079749999999e-12,1129254,145536,16328196
10950,2042448209,8269058,1.11632283e-12,1149382,145916,16474112
11000,2034225833,8265725,1.115872875e-12,1120818,145352,16619464
11050,2035430833,8266655,1.115998425e-12,1151048,145304,16764768
11100,2039884333,8267005,1.116045675e-12,1162415,146428,16911196
11150,2050908125,8265321,1.1158183350000001e-12,1107698,144488,17055684
11200,2046123417,11101980,1.4987673e-12,1124652,-3728344,13327340
11250,2176327667,8267491,1.116111285e-12,1178226,145844,13473184
11300,2292936625,8266441,1.1159695350000002e-12,1144088,145328,13618512
11350,2253757958,8267429,1.116102915e-12,1176200,145868,13764380
11400,2046601333,8269514,1.11638439e-12,1146214,145416,13909796
11450,2038301458,8266510,1.11597885e-12,1146317,145376,14055172
11500,2033029084,8266530,1.11598155e-12,1146993,145780,14200952
11550,2037609958,8266181,1.115934435e-12,1135648,144848,14345800
11600,2032867000,8266417,1.115966295e-12,1143311,145328,14491128
11650,2049114500,8269381,1.116366435e-12,1141889,145376,14636504
11700,2042057291,8266831,1.116022185e-12,1156751,145400,14781904
11750,2052812625,8266263,1.115945505e-12,1138297,145352,14927256
11800,2038801625,8266136,1.11592836e-12,1134188,145352,15072608
11850,2042717458,8268225,1.116210375e-12,1202059,146932,15219540
11900,2032818916,8269523,1.116385605e-12,1146506,144968,15364508
11950,2032228875,8267240,1.1160774000000001e-12,1170064,145796,15510304
12000,2033791291,8266488,1.11597588e-12,1145620,145376,15655680
12050,2031619083,8266961,1.116039735e-12,1160984,145376,15801056
12100,2064407833,8265083,1.115786205e-12,1099964,144176,15945232
12150,2194638167,8269286,1.11635361e-12,1138772,145064,16090296
12200,2259969208,8266640,1.1159964e-12,1150548,145352,16235648
12250,2016148500,8266706,1.11600531e-12,1152718,145392,16381040
12300,2035186792,8267093,1.116057555e-12,1165288,145448,16526488
12350,2038750166,8266802,1.1160182699999999e-12,1155802,145448,16671936
12400,2033514750,8269326,1.11635901e-12,1140090,145352,16817288
12450,2051511667,8268857,1.116295695e-12,1222595,147916,16965204
12500,2049341167,8265993,1.115909055e-12,1129512,145976,17111180
12550,2043074500,8267711,1.116140985e-12,1185368,146912,17258092
12600,2036833875,8268486,1.11624561e-12,1210536,147128,17405220
12650,2033125416,8267191,1.116070785e-12,1168452,147104,17552324
12700,2045789333,8267666,1.1161349099999999e-12,1183896,147572,17699896
12750,2034916750,8267754,1.1161467900000001e-12,1186756,147296,17847192
12800,2037339500,8267238,1.11607713e-12,1170000,147128,17994320
12850,2047185292,8271193,1.116611055e-12,1200754,148444,18142764
12900,2058239041,8267883,1.116164205e-12,1190950,147740,18290504
12950,2049499542,8268403,1.116234405e-12,1207870,147896,18438400
13000,2044119209,8269156,1.1163360599999999e-12,1232336,148740,18587140
13050,2201950208,8270155,1.1164709250000001e-12,1264810,148352,18735492
13100,2063722042,8273094,1.11686769e-12,1262552,148700,18884192
13150,2158392584,8269653,1.116403155e-12,1248486,148400,19032592
13200,2042840958,8269608,1.11639708e-12,1247030,148408,19181000
13250,2038463083,8269804,1.1164235400000001e-12,1253372,148352,19329352
13300,2046659291,8269668,1.11640518e-12,1248960,148352,19477704
13350,2048065292,8272606,1.11680181e-12,1246700,148464,19626168
13400,2047185417,8269765,1.116418275e-12,1252130,148280,19774448
13450,2037006000,8269795,1.1164223250000001e-12,1253082,148424,19922872
13500,2053870792,8269922,1.11643947e-12,1257208,148400,20071272
13550,2040973916,8270001,1.116450135e-12,1259790,148892,20220164
13600,2047169833,8273545,1.1169285750000002e-12,1277195,149284,20369448
13650,2039219792,8268275,1.116217125e-12,1203698,147584,20517032
13700,2052709166,8268540,1.1162529e-12,1212308,147852,20664884
13750,2034898083,8269590,1.1163946500000001e-12,1246422,148424,20813308
13800,2039129167,8270439,1.1165092650000002e-12,1274036,148748,20962056
13850,2052858125,11776124,1.58977674e-12,1244529,-4482344,16479712
13900,2048970209,8270263,1.116485505e-12,1268312,149476,16629188
13950,2164222416,8269016,1.11631716e-12,1227780,147824,16777012
14000,2297836625,8268676,1.11627126e-12,1216712,148092,16925104
14050,2055984500,8273222,1.11688497e-12,1245796,148040,17073144
14100,2034793125,8270158,1.11647133e-12,1264898,148496,17221640
14150,2044781500,8269327,1.116359145e-12,1237880,148724,17370364
14200,2034194541,8268902,1.11630177e-12,1224056,148400,17518764
14250,2040568417,8269286,1.11635361e-12,1236548,148328,17667092
14300,2051625208,8272895,1.116840825e-12,1235169,148408,17815500
14350,2044084375,8268790,1.11628665e-12,1220448,148064,17963564
14400,2043098209,8269622,1.11639897e-12,1247474,148772,18112336
14450,2045501458,8269749,1.1164161150000001e-12,1251592,149036,18261372
14500,2038727667,8269066,1.11632391e-12,1229390,148472,18409844
14550,2047763416,8273354,1.11690279e-12,1250052,148448,18558292
14600,2039548875,8268622,1.11626397e-12,1214990,148424,18706716
14650,2049271958,8269329,1.1163594149999999e-12,1237936,148936,18855652
14700,2040526667,8267426,1.11610251e-12,1176101,147464,19003116
14750,2057223458,8268357,1.116228195e-12,1206352,147720,19150836
14800,2047524291,8272603,1.116801405e-12,1225666,148424,19299260
14850,2141737083,8269178,1.1163390300000002e-12,1233032,148496,19447756
14900,2147526417,8268982,1.11631257e-12,1226662,148424,19596180
14950,2158726666,8269276,1.11635226e-12,1236218,148472,19744652
15000,2043943958,8269532,1.11638682e-12,1244558,148448,19893100
15050,2040402750,8274213,1.117018755e-12,1277978,149452,20042552
15100,2049949583,8268087,1.116191745e-12,1197594,147480,20190032
15150,2049137375,8269357,1.1163631949999999e-12,1238850,148424,20338456
15200,2048119667,8269349,1.116362115e-12,1238600,148448,20486904
15250,2047886625,8273289,1.1168940150000001e-12,1247943,148916,20635820
15300,2051379583,8269423,1.116372105e-12,1241004,148536,20784356
15350,2047891875,8269728,1.11641328e-12,1250918,148868,20933224
15400,2049986833,8269511,1.116383985e-12,1243867,148980,21082204
15450,2040844375,8267612,1.11612762e-12,1182142,147152,21229356
15500,2040668708,8272821,1.116830835e-12,1232760,148064,21377420
15550,2050732292,8270575,1.1165276250000001e-12,1278460,148748,21526168
15600,2032567125,8269676,1.11640626e-12,1249228,148448,21674616
15650,2037060042,8269453,1.116376155e-12,1241972,148376,21822992
15700,2043786334,8270316,1.11649266e-12,1270024,148820,21971812
15750,2226528084,8273883,1.116974205e-12,1267267,149356,22121168
15800,2343848416,8268037,1.116184995e-12,1195944,147200,22268368
15850,2308396208,8268254,1.11621429e-12,1202994,147296,22415664
15900,2055136500,8270446,1.11651021e-12,1274270,148916,22564580
15950,2037491875,8273896,1.11697596e-12,1267694,148916,22713496
16000,2035178334,8270403,1.116504405e-12,1272844,148844,22862340
16050,2037952375,8270177,1.116473895e-12,1265510,148400,23010740
16100,2044096000,8269850,1.1164297500000002e-12,1254873,149020,23159760
16150,2038278292,8270138,1.11646863e-12,1264248,148448,23308208
16200,2036207750,8273852,1.11697002e-12,1266250,148916,23457124
16250,2036266500,8270504,1.11651804e-12,1276138,148844,23605968
16300,2054027833,8269373,1.116365355e-12,1239386,148424,23754392
16350,2036831083,8270229,1.116480915e-12,1267196,148916,23903308
16400,2039484333,8270612,1.1165326200000001e-12,1279635,149524,24052832
16450,2048897167,8273736,1.11695436e-12,1262476,148548,24201380
16500,2036912584,8269379,1.116366165e-12,1239586,148400,24349780
16550,2037397875,8270086,1.11646161e-12,1262546,148376,24498156
16600,2037792875,8269544,1.11638844e-12,1244940,148400,24646556
16650,2067626584,8269890,1.1164351499999999e-12,1256200,148916,24795472
16700,2234880708,8273051,1.116861885e-12,1240232,148440,24943912
16750,2278954125,8270745,1.116550575e-12,1283959,149692,25093604
16800,2038249042,8268429,1.116237915e-12,1208682,147812,25241416
16850,2042820584,8268653,1.116268155e-12,1215961,147704,25389120
16900,2050267750,8273363,1.116904005e-12,1250352,148472,25537592
16950,2051228917,8269492,1.1163814200000001e-12,1243234,148472,25686064
17000,2042571917,12569098,1.69682823e-12,1243635,-5458388,20227676
17050,2038276542,8269465,1.116377775e-12,1242374,148448,20376124
17100,2048170250,8269722,1.11641247e-12,1250716,148964,20525088
17150,2041970791,8272938,1.1168466300000001e-12,1211525,148360,20673448
17200,2055231875,8268923,1.116304605e-12,1224762,148040,20821488
17250,2044470916,8268866,1.1162969100000001e-12,1222883,148376,20969864
17300,2049221167,8269453,1.116376155e-12,1241974,148424,21118288
17350,2035481958,8269559,1.116390465e-12,1245426,148868,21267156
17400,2039569375,8273793,1.1169620550000001e-12,1239301,148512,21415668
17450,2040758833,8269604,1.11639654e-12,1246886,148932,21564600
17500,2125751125,8269394,1.11636819e-12,1240053,149020,21713620
17550,2183231375,8268581,1.1162584350000001e-12,1213642,147848,21861468
17600,2194411000,8269474,1.11637899e-12,1242677,148724,22010192
17650,2284278125,8273404,1.11690954e-12,1226664,148400,22158592
17700,2222833500,8269286,1.11635361e-12,1236544,148448,22307040
17750,2037207750,8269126,1.11633201e-12,1231366,148868,22455908
17800,2036513333,8268996,1.1163144600000001e-12,1227140,148400,22604308
17850,2037407833,8273367,1.116904545e-12,1225477,148792,22753100
17900,2038880416,8268152,1.11620052e-12,1199698,147908,22901008
17950,2048335417,8268267,1.116216045e-12,1203432,148016,23049024
18000,2043199584,8269670,1.1164054499999999e-12,1249044,148424,23197448
18050,2052787834,8269913,1.116438255e-12,1256937,148448,23345896
18100,2035602833,8273255,1.116889425e-12,1221820,148400,23494296
18150,2038817250,8269001,1.116315135e-12,1227294,148988,23643284
18200,2059516791,8268881,1.116298935e-12,1223398,148472,23791756
18250,2033377375,8269899,1.1164363649999999e-12,1256475,149288,23941044
18300,2032929666,8268702,1.1162747700000001e-12,1217552,148232,24089276
18350,2041752500,8273342,1.11690117e-12,1224646,148916,24238192
18400,2364759500,8268864,1.11629664e-12,1222830,148352,24386544
18450,2218153458,8269039,1.1163202650000001e-12,1228532,148448,24534992
18500,2542731458,8269358,1.11636333e-12,1238898,148924,24683916
18550,2235625666,8273052,1.1168620199999999e-12,1215244,147584,24831500
18600,2045180750,8269229,1.116345915e-12,1234706,148172,24979672
18650,2038220000,8270186,1.11647511e-12,1265782,148400,25128072
18700,2048199333,8270029,1.116453915e-12,1260700,148352,25276424
18750,2053166375,8269901,1.116436635e-12,1256532,148400,25424824
18800,2052105125,8274202,1.11701727e-12,1252607,148472,25573296
18850,2045573709,8269833,1.1164274550000001e-12,1254320,148280,25721576
18900,2052731458,8269678,1.11640653e-12,1249290,148256,25869832
18950,2038005375,8269329,1.1163594149999999e-12,1237935,148388,26018220
19000,2048947291,8266841,1.116023535e-12,1157094,146048,26164268
19050,2035584167,8272498,1.11678723e-12,1197228,146792,26311060
19100,2043752250,8266817,1.116020295e-12,1156316,146744,26457804
19150,2049216958,8267610,1.1161273499999999e-12,1182066,147152,26604956
19200,2054083000,8267760,1.1161476e-12,1186961,147296,26752252
19250,2048763875,8272249,1.116753615e-12,1189140,147564,26899816
19300,2044565875,8267386,1.11609711e-12,1174784,147080,27046896
19350,2065645250,8268198,1.11620673e-12,1201189,148096,27194992
19400,2083472333,8268280,1.1162178e-12,1203842,147812,27342804
19450,2159616333,8268288,1.11621888e-12,1204106,147632,27490436
19500,2196497708,8274030,1.11699405e-12,1247015,148520,27638956
19550,2039730250,8270182,1.11647457e-12,1265674,148400,27787356
19600,2040993917,8269250,1.11634875e-12,1235390,148424,27935780
19650,2039080708,8269339,1.116360765e-12,1238288,148868,28084648
19700,2047972458,8268945,1.116307575e-12,1225456,148376,28233024
19750,2054552791,8272591,1.116799785e-12,1200241,147688,28380712
19800,2043546917,8267460,1.1161071000000001e-12,1177212,147056,28527768
19850,2040944417,8267643,1.116131805e-12,1183170,147248,28675016
19900,2049204375,8267856,1.1161605600000002e-12,1190081,147692,28822708
19950,2037080291,8267849,1.116159615e-12,1189846,147296,28970004
20000,2035658917,8271816,1.11669516e-12,1175078,147104,29117108
20050,2042368916,8268584,1.11625884e-12,1213738,147152,29264260
20100,2049738709,8267750,1.11614625e-12,1186624,147080,29411340
20150,2043697500,8266627,1.115994645e-12,1150145,147032,29558372
20200,2045338416,8267316,1.11608766e-12,1172534,146928,29705300
20250,2090879917,8273058,1.11686283e-12,1215428,147732,29853032
20300,2249274416,8267904,1.11616704e-12,1191634,147096,30000128
20350,2321247375,8268055,1.116187425e-12,1196560,147596,30147724
20400,2215971542,8267934,1.11617109e-12,1192594,147176,30294900
20450,2043501459,8272229,1.1167509150000001e-12,1188474,147152,30442052
20500,2036836334,8268022,1.11618297e-12,1195453,147892,30589944
20550,2035874250,8267988,1.11617838e-12,1194362,147444,30737388
20600,2045955083,8268338,1.11622563e-12,1205748,147248,30884636
20650,2050042625,8268144,1.11619944e-12,1199430,147152,31031788
20700,2051675750,8272293,1.116759555e-12,1190578,147032,31178820
20750,2040351209,8267411,1.116100485e-12,1175620,147224,31326044
20800,2037439334,13527928,1.82627028e-12,1205968,-6578940,24747104
20850,2041249583,8267958,1.11617433e-12,1193392,147296,24894400
20900,2039502083,8268695,1.116273825e-12,1217351,147608,25042008
20950,2046168125,8272415,1.1167760250000001e-12,1164502,146408,25188416
21000,2048884750,8268088,1.11619188e-12,1197606,147176,25335592
21050,2048693459,8268578,1.11625803e-12,1213530,147176,25482768
21100,2043948084,8268648,1.11626748e-12,1215816,147788,25630556
21150,2197517166,8269697,1.116409095e-12,1249920,148328,25778884
21200,2079795875,8275032,1.11712932e-12,1249534,148344,25927228
21250,2419581958,8270562,1.1165258699999999e-12,1278036,148940,26076168
21300,2162469750,8270053,1.116457155e-12,1261484,148376,26224544
21350,2261765000,8270686,1.11654261e-12,1282050,149012,26373556
21400,2036074875,8275577,1.117202895e-12,1267263,148960,26522516
21450,2032213084,8269480,1.1163798e-12,1242860,147968,26670484
21500,2035333250,8269056,1.11632256e-12,1229078,147848,26818332
21550,2034348750,8269322,1.11635847e-12,1237730,148124,26966456
21600,2038243458,8268588,1.11625938e-12,1213860,147788,27114244
21650,2049160041,8275129,1.117142415e-12,1252714,148256,27262500
21700,2036165167,8269540,1.1163879e-12,1244807,148400,27410900
21750,2037979833,8269490,1.11638115e-12,1243168,148368,27559268
21800,2033662584,8269252,1.11634902e-12,1235458,148376,27707644
21850,2039956875,8269748,1.1164159800000001e-12,1251574,148700,27856344
21900,2055323375,8275128,1.11714228e-12,1252678,148376,28004720
21950,2038777500,8269071,1.116324585e-12,1229575,148096,28152816
22000,2048406083,8268621,1.116263835e-12,1214922,147488,28300304
22050,2040794250,8269787,1.116421245e-12,1252836,147992,28448296
22100,2149987792,8269191,1.116340785e-12,1233466,148400,28596696
22150,2305891417,8269186,1.11634011e-12,1233286,148352,28745048
22200,2195011042,8270075,1.116460125e-12,1262197,148868,28893916
22250,2021228875,8269376,1.1163657599999999e-12,1239480,148448,29042364
22300,2039200375,8269132,1.1163328200000001e-12,1231532,148400,29190764
22350,2039072125,8274353,1.1170376550000002e-12,1227487,148636,29339400
22400,2047473333,8267413,1.1161007550000001e-12,1175688,147248,29486648
22450,2048571917,8269712,1.11641112e-12,1250392,148424,29635072
22500,2045849292,8269684,1.11640734e-12,1249496,148940,29784012
22550,2038296875,8269223,1.116345105e-12,1234508,148304,29932316
22600,2055367375,8275124,1.1171417400000001e-12,1252524,148868,30081184
22650,2035463834,8269757,1.116417195e-12,1251868,148544,30229728
22700,2035102791,8270323,1.116493605e-12,1270251,149356,30379084
22750,2043910625,8269952,1.11644352e-12,1258202,148916,30528000
22800,2043829458,8268693,1.1162735550000001e-12,1217270,147992,30675992
22850,2037202750,8275578,1.1172030299999999e-12,1267288,148844,30824836
22900,2038220417,8269912,1.1164381200000001e-12,1256884,148892,30973728
22950,2038542333,8269934,1.11644109e-12,1257600,148448,31122176
23000,2163794250,8269848,1.11642948e-12,1254807,149044,31271220
23050,2310627833,8270299,1.1164903650000002e-12,1269464,148448,31419668
23100,2074790250,8275085,1.117136475e-12,1251287,148400,31568068
23150,2154110334,8269589,1.116394515e-12,1246383,148772,31716840
23200,2036999208,8269986,1.11644811e-12,1259306,148352,31865192
23250,2045110792,8269412,1.11637062e-12,1240659,148352,32013544
23300,2048629000,8275443,1.117184805e-12,1262904,148772,32162316
23350,2058825042,8270281,1.1164879350000001e-12,1268873,148912,32311228
23400,2060270125,8268770,1.11628395e-12,1219779,147644,32458872
23450,2044332459,8269689,1.116408015e-12,1249656,148328,32607200
23500,2037433959,8269936,1.1164413599999999e-12,1257686,148860,32756060
23550,2043475250,8275322,1.11716847e-12,1258969,148376,32904436
23600,2037928042,8269453,1.116376155e-12,1241990,148376,33052812
23650,2038370750,8269551,1.116389385e-12,1245158,148448,33201260
23700,2038742792,8269157,1.116336195e-12,1232346,148400,33349660
23750,2048401709,8269291,1.1163542850000001e-12,1236703,148384,33498044
23800,2046716500,8274686,1.11708261e-12,1238298,147968,33646012
23850,2054176875,8269532,1.11638682e-12,1244546,148112,33794124
23900,2100737875,8269880,1.1164338e-12,1255844,148520,33942644
23950,2211932208,8269396,1.11636846e-12,1240118,148352,34090996
24000,2184485000,8269482,1.1163800700000001e-12,1242922,148424,34239420
24050,2037977125,8275105,1.117139175e-12,1251930,148868,34388288
24100,2036783959,8269535,1.116387225e-12,1244646,148664,34536952
24150,2040977667,8269608,1.11639708e-12,1247003,149476,34686428
24200,2038605375,8269123,1.1163316050000001e-12,1231266,148472,34834900
24250,2033040583,8268906,1.11630231e-12,1224220,148544,34983444
24300,2045392042,8274245,1.117023075e-12,1223980,148772,35132216
24350,2039163875,8269345,1.116361575e-12,1238455,148916,35281132
24400,2045974792,8268500,1.1162475e-12,1211016,148400,35429532
24450,2037406791,8269016,1.11631716e-12,1227764,148592,35578124
24500,2046574042,8269591,1.116394785e-12,1246479,149224,35727348
24550,2035255375,8275150,1.11714525e-12,1253392,148340,35875688
24600,2032014834,8269114,1.11633039e-12,1230942,147924,36023612
24650,2031020584,8270070,1.1164594500000002e-12,1262038,148844,36172456
24700,2038274083,8269699,1.116409365e-12,1249972,148400,36320856
24750,2101208542,8269402,1.11636927e-12,1240312,148304,36469160
24800,2154776042,8269782,1.11642057e-12,1252684,148472,36617632
24850,2258182709,8269995,1.116449325e-12,1259587,148328,36765960
24900,2175791250,8269890,1.1164351499999999e-12,1256190,149356,36915316
24950,2044677542,8268834,1.1162925899999999e-12,1221872,147680,37062996
25000,2035593792,8274277,1.117027395e-12,1225017,147888,37210884
25050,2053494708,8268983,1.1163127050000001e-12,1226720,148148,37359032
25100,2042487708,8268263,1.116215505e-12,1203318,147788,37506820
25150,2039074167,8268696,1.11627396e-12,1217370,147944,37654764
25200,2053748333,8269609,1.116397215e-12,1247042,148448,37803212
25250,2042483417,8274390,1.1170426500000002e-12,1228672,148376,37951588
25300,2035452458,8269545,1.116388575e-12,1244976,148868,38100456
25350,2036270459,14679083,1.981676205e-12,1241430,-7940888,30159568
25400,2049721416,8270239,1.116482265e-12,1267522,149620,30309188
25450,2036067667,8267779,1.116150165e-12,1187579,147200,30456388
25500,2052207083,8274901,1.117111635e-12,1209236,147584,30603972
25550,2035462208,8269881,1.116433935e-12,1255882,148304,30752276
25600,2032674417,8269334,1.11636009e-12,1238122,148472,30900748
25650,2196316583,8269168,1.11633768e-12,1232722,148520,31049268
25700,2215430042,8269198,1.11634173e-12,1233687,148448,31197716
25750,2103902708,8269305,1.1163561750000001e-12,1237156,148400,31346116
25800,2040603583,8269372,1.11636522e-12,1239360,148520,31494636
25850,2035223917,8270830,1.11656205e-12,1286724,150084,31644720
25900,2037547667,8269162,1.11633687e-12,1232504,148160,31792880
25950,2043898250,8275437,1.1171839950000001e-12,1226656,147920,31940800
26000,2046634042,8270106,1.11646431e-12,1263188,149012,32089812
26050,2041047125,8269386,1.11636711e-12,1239818,148304,32238116
26100,2034439750,8269595,1.116395325e-12,1246601,148400,32386516
26150,2050283250,8269302,1.11635577e-12,1237070,148448,32534964
26200,2033726375,8276621,1.117343835e-12,1265151,149008,32683972
26250,2042398417,8268413,1.116235755e-12,1208184,147740,32831712
26300,2032539167,8269679,1.1164066649999999e-12,1249335,148472,32980184
26350,2039892250,8269720,1.1164122000000001e-12,1250668,148400,33128584
26400,2049118083,8276287,1.117298745e-12,1254284,148424,33277008
26450,2057500125,8269890,1.1164351499999999e-12,1256196,148448,33425456
26500,2036999416,8269977,1.1164468950000001e-12,1259010,148868,33574324
26550,2074905791,8269736,1.11641436e-12,1251180,148400,33722724
26600,2164364458,8270802,1.11655827e-12,1285831,149272,33871996
26650,2255037833,8277513,1.117464255e-12,1294126,149948,34021944
26700,2059745709,8270847,1.1165643449999999e-12,1287290,149600,34171544
26750,2026487333,8271225,1.116615375e-12,1299552,150116,34321660
26800,2055935750,8271018,1.11658743e-12,1292822,149624,34471284
26850,2037728792,8270658,1.11653883e-12,1281150,149672,34620956
26900,2034148542,8277264,1.1174306400000001e-12,1286050,150068,34771024
26950,2052043625,8270341,1.116496035e-12,1270821,149576,34920600
27000,2043107125,8270354,1.11649779e-12,1271276,149480,35070080
27050,2054171292,8271300,1.1166255e-12,1302010,149384,35219464
27100,2040391417,8270651,1.116537885e-12,1280916,149744,35369208
27150,2045628708,8277145,1.117414575e-12,1282168,149600,35518808
27200,2034052250,8270934,1.1165760900000002e-12,1290125,150140,35668948
27250,2034893166,8270494,1.11651669e-12,1275798,149616,35818564
27300,2038706208,8272648,1.11680748e-12,1345809,151348,35969912
27350,2049546333,8270439,1.1165092650000002e-12,1274025,149216,36119128
27400,2058850250,8276843,1.1173738050000001e-12,1272368,149312,36268440
27450,2120140208,8271542,1.1166581700000001e-12,1309864,149592,36418032
27500,2081369875,8270930,1.11657555e-12,1289964,149672,36567704
27550,2192230084,8272089,1.1167320150000001e-12,1327660,150140,36717844
27600,2291912750,8276833,1.117372455e-12,1272046,148760,36866604
27650,2037254875,8271214,1.11661389e-12,1299218,149696,37016300
27700,2049733875,8270922,1.11657447e-12,1289712,149672,37165972
27750,2059776959,8271422,1.11664197e-12,1305962,150164,37316136
27800,2049694916,8270784,1.11655584e-12,1285236,149624,37465760
27850,2047005500,8277547,1.117468845e-12,1295234,149624,37615384
27900,2034061958,8270817,1.116560295e-12,1286314,149624,37765008
27950,2044856875,8271011,1.116586485e-12,1292624,149896,37914904
28000,2034263292,8269687,1.116407745e-12,1249578,148712,38063616
28050,2034956834,8269396,1.11636846e-12,1240114,148352,38211968
28100,2044250666,8276534,1.11733209e-12,1262337,148892,38360860
28150,2053660458,8270119,1.116466065e-12,1263626,148880,38509740
28200,2054704167,8271104,1.1165990399999999e-12,1295630,149648,38659388
28250,2049322375,8271902,1.11670677e-12,1321566,149648,38809036
28300,2045936000,8272023,1.116723105e-12,1325503,149988,38959024
28350,2055973042,8277676,1.11748626e-12,1299440,149576,39108600
28400,2088548125,8271325,1.116628875e-12,1302812,149552,39258152
28450,2206499584,8270458,1.11651183e-12,1274625,149392,39407544
28500,2296973292,8269824,1.11642624e-12,1254040,148688,39556232
28550,2044451208,8277675,1.117486125e-12,1299404,149144,39705376
28600,2038873750,8271463,1.116647505e-12,1307318,149624,39855000
28650,2037613625,8270716,1.11654666e-12,1283016,149696,40004696
28700,2036018417,8270830,1.11656205e-12,1286728,149672,40154368
28750,2044220792,8271128,1.11660228e-12,1296420,150116,40304484
28800,2049005000,8276945,1.1173875750000002e-12,1275690,149624,40454108
28850,2046974625,8270205,1.116477675e-12,1266401,149464,40603572
28900,2037242542,8270038,1.11645513e-12,1260990,149096,40752668
28950,2045307959,8271341,1.116631035e-12,1303340,149696,40902364
29000,2042516000,8271387,1.116637245e-12,1304840,150116,41052480
29050,2039094292,8277529,1.117466415e-12,1294650,149360,41201840
29100,2035803292,8271031,1.116589185e-12,1293274,149672,41351512
29150,2037176375,8271194,1.11661119e-12,1298574,150020,41501532
29200,2037046334,8271311,1.116626985e-12,1302352,150232,41651764
29250,2075755167,8270672,1.11654072e-12,1281600,149216,41800980
29300,2131908209,8276381,1.117311435e-12,1257362,148964,41949944
29350,2221320125,8270419,1.116506565e-12,1273368,149144,42099088
29400,2402974167,8270493,1.116516555e-12,1275764,149480,42248568
29450,2048545666,8270843,1.116563805e-12,1287158,149600,42398168
29500,2041358875,8277293,1.117434555e-12,1286985,149600,42547768
29550,2041354000,8271096,1.11659796e-12,1295380,149648,42697416
29600,2036796541,8270292,1.11648942e-12,1269253,149944,42847360
29650,2035334834,8268884,1.1162993400000001e-12,1223476,148664,42996024
29700,2036987417,8270433,1.116508455e-12,1273838,149924,43145948
29750,2052672625,8276545,1.1173335749999999e-12,1262690,149504,43295452
29800,2036077541,8269817,1.116425295e-12,1253808,149576,43445028
29850,2044569208,8270724,1.1165477400000002e-12,1283286,150044,43595072
29900,2047474875,8270032,1.11645432e-12,1260794,149600,43744672
29950,2054490333,8269961,1.116444735e-12,1258500,149552,43894224
30000,2033995709,8276539,1.117332765e-12,1262499,149860,44044084
30050,2032579458,8272200,1.116747e-12,1331264,149600,44193684
30100,2038420583,8270428,1.11650778e-12,1273672,149672,44343356
30150,2049666125,8270581,1.116528435e-12,1278631,150164,44493520
30200,2297059416,8270349,1.116497115e-12,1271102,149576,44643096
30250,2351634667,8270227,1.116480645e-12,1267146,149696,44792792
30300,2209633834,8270362,1.11649887e-12,1271534,149792,44942584
30350,2041321000,8271663,1.116674505e-12,1313809,151036,45093620
30400,2038803583,8270439,1.1165092650000002e-12,1274013,149408,45243028
30450,2043878541,8277133,1.117412955e-12,1281776,149696,45392724
30500,2043381208,8270767,1.1165535450000001e-12,1284686,150044,45542768
30550,2040438666,8271665,1.116674775e-12,1313872,149408,45692176
30600,2034554208,8271098,1.1165982300000001e-12,1295442,149372,45841548
30650,2047639750,8270648,1.11653748e-12,1280816,149672,45991220
30700,2037957417,8277500,1.1174625e-12,1293722,149624,46140844
30750,2051194625,8271103,1.116598905e-12,1295598,150020,46290864
30800,2041763375,16057502,2.1677627699999998e-12,1295782,-9649644,36641220
30850,2032101625,8271771,1.1166890850000001e-12,1317323,150892,36792112
30900,2034586708,8269552,1.11638952e-12,1245200,148664,36940776
30950,2044230875,8277525,1.1174658750000001e-12,1251152,148856,37089632
31000,2060206083,8269717,1.116411795e-12,1250546,149180,37238812
31050,2202916125,8269627,1.1163996450000001e-12,1247634,148416,37387228
31100,2555337958,8270196,1.11647646e-12,1266112,149060,37536288
31150,3830712208,8278871,1.117647585e-12,1269556,148688,37684976
31200,2049536791,8270550,1.11652425e-12,1277620,149496,37834472
31250,2040210917,8271539,1.116657765e-12,1309764,149696,37984168
31300,2048708750,8271038,1.11659013e-12,1293508,149528,38133696
31350,2048984208,8271325,1.116628875e-12,1302812,149576,38283272
31400,2057393875,8278781,1.117635435e-12,1291960,149528,38432800
31450,2050749875,8271686,1.11667761e-12,1314558,150412,38583212
31500,2049673917,8269533,1.116386955e-12,1244588,148568,38731780
31550,2038697792,8270155,1.1164709250000001e-12,1264786,148800,38880580
31600,2052194833,8272162,1.11674187e-12,1330034,149996,39030576
31650,2037212375,8278857,1.117645695e-12,1294442,149648,39180224
31700,2033896125,8271723,1.116682605e-12,1315760,150068,39330292
31750,2047538833,8271125,1.116601875e-12,1296321,150036,39480328
31800,2035796375,8270864,1.11656664e-12,1287839,149632,39629960
31850,2031601083,8270019,1.116452565e-12,1260376,148616,39778576
31900,2249041875,8271068,1.11659418e-12,1294457,149600,39928176
31950,2100381542,8271382,1.11663657e-12,1304681,149648,40077824
32000,2178246334,8271440,1.1166444e-12,1306566,149624,40227448
32050,2198301250,8272449,1.116780615e-12,1339346,150164,40377612
32100,2270070834,8278822,1.11764097e-12,1293286,149696,40527308
32150,2049575959,8270530,1.11652155e-12,1276972,149720,40677028
32200,2040789833,8270850,1.11656475e-12,1287377,150388,40827416
32250,2045540125,8270613,1.1165327550000001e-12,1279664,149312,40976728
32300,2049659417,8270118,1.1164659300000001e-12,1263587,149468,41126196
32350,2053947750,8278032,1.11753432e-12,1267618,149552,41275748
32400,2034788292,8270297,1.116490095e-12,1269402,149528,41425276
32450,2048009958,8270578,1.11652803e-12,1278548,149552,41574828
32500,2037158750,8270450,1.11651075e-12,1274400,149720,41724548
32550,2046913042,8271338,1.11663063e-12,1303227,149944,41874492
32600,2023744666,8277263,1.117430505e-12,1242639,148496,42022988
32650,2055313209,8269982,1.11644757e-12,1259180,148928,42171916
32700,2056532584,8271169,1.1166078149999999e-12,1297755,149528,42321444
32750,2052025375,8272039,1.116725265e-12,1326030,150140,42471584
32800,2039351916,8278526,1.11760101e-12,1283682,149552,42621136
32850,2145613958,8271115,1.116600525e-12,1295988,149624,42770760
32900,2445358292,8271451,1.116645885e-12,1306912,149972,42920732
32950,2185371417,8270177,1.116473895e-12,1265505,149520,43070252
33000,2043601584,8268832,1.11629232e-12,1221786,147704,43217956
33050,2036947708,8277555,1.117469925e-12,1252106,148248,43366204
33100,2035269750,8270280,1.1164878e-12,1268850,148916,43515120
33150,2036396583,8268930,1.11630555e-12,1224992,148328,43663448
33200,2033108875,8269003,1.116315405e-12,1227366,148472,43811920
33250,2048879583,8269414,1.11637089e-12,1240696,148932,43960852
33300,2044628709,8277081,1.1174059350000001e-12,1236705,148784,44109636
33350,2037299375,8267783,1.116150705e-12,1187720,147536,44257172
33400,2041144333,8269435,1.1163737250000001e-12,1241384,148496,44405668
33450,2034314625,8269704,1.11641004e-12,1250146,149060,44554728
33500,2037748583,8276540,1.1173329000000001e-12,1219134,148376,44703104
33550,2046108333,8269750,1.11641625e-12,1251649,148400,44851504
33600,2042137833,8268785,1.116285975e-12,1220274,148400,44999904
33650,2035861292,8268602,1.11626127e-12,1214336,148376,45148280
33700,2035851625,8271145,1.1166045750000001e-12,1296951,149800,45298080
33750,2282702917,8277745,1.1174955750000001e-12,1258300,149144,45447224
33800,2192038375,8270691,1.116543285e-12,1282224,149552,45596776
33850,2309343250,8271136,1.1166033600000001e-12,1296686,150140,45746916
33900,2222186208,8270879,1.1165686650000001e-12,1288322,149696,45896612
33950,2035238875,8271139,1.116603765e-12,1296767,150164,46046776
34000,2038590417,8278288,1.11756888e-12,1275928,149624,46196400
34050,2030834333,8272094,1.11673269e-12,1327823,150724,46347124
34100,2035857875,8269198,1.11634173e-12,1233690,147932,46495056
34150,2033762041,8269880,1.1164338e-12,1255867,148964,46644020
34200,2046743667,8269830,1.11642705e-12,1254220,148472,46792492
34250,2044982875,8277784,1.11750084e-12,1259578,148796,46941288
34300,2034561417,8269745,1.116415575e-12,1251458,148868,47090156
34350,2043011791,8270333,1.1164949549999999e-12,1270583,149248,47239404
34400,2037729792,8270354,1.11649779e-12,1271260,148928,47388332
34450,2034507416,8270794,1.11655719e-12,1285542,149420,47537752
34500,2033390667,8278582,1.11760857e-12,1285507,148904,47686656
34550,2032877250,8270647,1.116537345e-12,1280796,148760,47835416
34600,2085274625,8269501,1.1163826350000001e-12,1243542,148916,47984332
34650,2119758708,8270304,1.11649104e-12,1269646,149096,48133428
34700,2237837250,8278316,1.11757266e-12,1276836,149672,48283100
34750,2149580208,8270811,1.116559485e-12,1286118,150084,48433184
34800,2042655500,8270016,1.11645216e-12,1260278,149480,48582664
34850,2049478541,8270056,1.11645756e-12,1261590,149552,48732216
34900,2042889750,8270059,1.116457965e-12,1261678,149600,48881816
34950,2043068333,8277780,1.1175003e-12,1259449,149788,49031604
35000,2046907000,8269631,1.116400185e-12,1247766,148952,49180556
35050,2047400458,8272659,1.116808965e-12,1346174,149924,49330480
35100,2043367708,8271508,1.11665358e-12,1308776,150068,49480548
35150,2033704750,8271379,1.116636165e-12,1304584,149672,49630220
35200,2042408083,8279118,1.11768093e-12,1302904,150116,49780336
35250,2038338375,8271031,1.116589185e-12,1293253,150088,49930424
35300,2030623791,8270096,1.11646296e-12,1262884,149000,50079424
35350,2045482334,8271200,1.116612e-12,1298748,149600,50229024
35400,2040079000,8270759,1.116552465e-12,1284416,149528,50378552
35450,2045322209,8278836,1.11764286e-12,1293754,149600,50528152
35500,2181218875,8270930,1.11657555e-12,1289964,149624,50677776
35550,2091115125,8270605,1.116531675e-12,1279424,149624,50827400
35600,2299067375,8270592,1.11652992e-12,1279000,150044,50977444
35650,2207961833,8277916,1.11751866e-12,1263864,150064,51127508
35700,2043871333,8269426,1.1163725100000001e-12,1241110,148904,51276412
35750,2037191542,8268908,1.11630258e-12,1224262,148700,51425112
35800,2031774916,8270069,1.116459315e-12,1262007,149264,51574376
35850,2036614375,8270289,1.116489015e-12,1269152,149600,51723976
35900,2043629500,8278168,1.11755268e-12,1272030,149900,51873876
35950,2045961625,8270107,1.1164644450000002e-12,1263240,149648,52023524
36000,2054393292,8270631,1.1165351850000001e-12,1280274,150436,52173960
36050,2039084250,8270936,1.11657636e-12,1290167,148880,52322840
36100,2042088834,8270799,1.116557865e-12,1285732,149648,52472488
36150,2036758084,8279181,1.117689435e-12,1304954,150164,52622652
36200,2053329208,8270956,1.11657906e-12,1290818,149648,52772300
36250,2053140667,8270940,1.1165769e-12,1290310,149672,52921972
36300,2038531958,8271041,1.116590535e-12,1293586,150044,53072016
36350,2041580917,8270906,1.1165723100000002e-12,1289184,149672,53221688
36400,2062904750,8278173,1.117553355e-12,1272219,149632,53371320
36450,2221885584,8270583,1.116528705e-12,1278712,149208,53520528
36500,2263889166,8271282,1.11662307e-12,1301440,149624,53670152
36550,2083356750,8271259,1.116619965e-12,1300674,149600,53819752
36600,2039419291,8279215,1.1176940250000002e-12,1306051,150068,53969820
36650,2047551584,8270984,1.11658284e-12,1291732,149528,54119348
36700,2053795875,8271264,1.11662064e-12,1300836,150092,54269440
36750,2050317000,8271638,1.11667113e-12,1312975,150280,54419720
36800,2037765334,8270776,1.1165547600000001e-12,1284978,149348,54569068
36850,2032346125,8279540,1.1177379e-12,1316632,149892,54718960
36900,2046457291,8271356,1.11663306e-12,1303826,149600,54868560
36950,2034455583,8272007,1.116720945e-12,1324982,150068,55018628
37000,2044964375,8271862,1.11670137e-12,1320288,150068,55168696
37050,2039455417,8271004,1.11658554e-12,1292392,149600,55318296
37100,2032852334,8279325,1.117708875e-12,1309657,150628,55468924
37150,2035590709,8271481,1.116649935e-12,1307898,150212,55619136
37200,2039559958,8270834,1.11656259e-12,1286866,149648,55768784
37250,2198605500,8270911,1.116572985e-12,1289374,150020,55918804
37300,9037576667,17710578,2.39092803e-12,1274170,-11544528,44374276
37350,2047120709,8270376,1.11650076e-12,1271962,149648,44523924
37400,2041379167,8272323,1.116763605e-12,1335269,151244,44675168
37450,2036242334,8279324,1.11770874e-12,1258236,149144,44824312
37500,2039103417,8270684,1.11654234e-12,1282000,149576,44973888
37550,2038167584,8271418,1.11664143e-12,1305852,149712,45123600
37600,2036235333,8269528,1.1163862800000002e-12,1244422,148592,45272192
37650,2040241000,8270802,1.11655827e-12,1285812,149528,45421720
37700,2047731750,8271815,1.116695025e-12,1318740,150092,45571812
37750,2036753125,8271535,1.116657225e-12,1309634,149648,45721460
37800,2043385625,8271608,1.1166670799999999e-12,1312016,150068,45871528
37850,2054747625,8271322,1.11662847e-12,1302722,149600,46021128
37900,2041331000,8280496,1.11786696e-12,1296304,149796,46170924
37950,2034606417,8270034,1.11645459e-12,1260880,148940,46319864
38000,2034481792,8270920,1.1165742e-12,1289645,149648,46469512
38050,2049202709,8271355,1.1166329250000001e-12,1303784,149600,46619112
38100,2057415458,8271578,1.1166630300000002e-12,1311048,150044,46769156
38150,2045648875,8280753,1.1179016549999999e-12,1304660,149504,46918660
38200,2165280708,8270949,1.116578115e-12,1290588,149624,47068284
38250,2332729083,8270942,1.11657717e-12,1290368,149648,47217932
38300,2309380500,8270938,1.11657663e-12,1290255,149908,47367840
38350,2052461000,8270297,1.116490095e-12,1269398,148880,47516720
38400,2059206666,8280324,1.11784374e-12,1290727,149288,47666008
38450,2044134000,8271539,1.116657765e-12,1309774,149576,47815584
38500,2048959500,8271422,1.11664197e-12,1305986,149552,47965136
38550,2047121542,8271200,1.116612e-12,1298756,149552,48114688
38600,2043444416,8281548,1.11800898e-12,1330520,150164,48264852
38650,2041174167,8271715,1.1166815250000001e-12,1315507,150340,48415192
38700,2037895583,8270850,1.11656475e-12,1287393,149492,48564684
38750,2033533334,8271370,1.1166349499999999e-12,1304266,150092,48714776
38800,2038915333,8271197,1.1166115949999999e-12,1298656,149640,48864416
38850,2040864542,8281046,1.11794121e-12,1314186,149720,49014136
38900,2034091291,8271591,1.116664785e-12,1311452,149972,49164108
38950,2038557042,8270910,1.11657285e-12,1289350,149576,49313684
39000,2036639583,8270468,1.11651318e-12,1274967,149536,49463220
39050,2147601583,8271407,1.116639945e-12,1305472,149660,49612880
39100,2249688917,8280170,1.11782295e-12,1285714,149636,49762516
39150,2502149333,8271553,1.116659655e-12,1310216,150188,49912704
39200,2263071916,8271363,1.116634005e-12,1304068,149696,50062400
39250,2181794792,8271210,1.1166133500000001e-12,1299097,149720,50212120
39300,2043784333,8282045,1.118076075e-12,1346658,151476,50363596
39350,2034192958,8268821,1.116290835e-12,1221428,147992,50511588
39400,2038576250,8269113,1.1163302550000001e-12,1230934,148328,50659916
39450,2041529000,8268350,1.11622725e-12,1206119,147704,50807620
39500,2049401709,8269617,1.116398295e-12,1247296,148868,50956488
39550,2042712667,8278113,1.1175452550000001e-12,1218868,148400,51104888
39600,2035136459,8269775,1.116419625e-12,1252454,148916,51253804
39650,2042483584,8269609,1.116397215e-12,1247050,148416,51402220
39700,2047172250,8269150,1.11633525e-12,1232125,148516,51550736
39750,2038418042,8268948,1.11630798e-12,1225568,148016,51698752
39800,2058513083,8279034,1.11766959e-12,1248804,148820,51847572
39850,2062263875,8269612,1.11639762e-12,1247141,148844,51996416
39900,2059939417,8269351,1.116362385e-12,1238676,148400,52144816
39950,2039841750,8269162,1.11633687e-12,1232540,148472,52293288
40000,2088254958,8269074,1.11632499e-12,1229650,148376,52441664
40050,2201803333,8278642,1.11761667e-12,1236067,148804,52590468
40100,2086829417,8269218,1.11634443e-12,1234354,148424,52738892
40150,2224701458,8268779,1.116285165e-12,1220066,148424,52887316
40200,2051786083,8268951,1.116308385e-12,1225668,148400,53035716
40250,2042244625,8278320,1.1175732e-12,1225582,148440,53184156
40300,2053352042,8269034,1.11631959e-12,1228356,148416,53332572
40350,2055654125,8269130,1.11633255e-12,1231462,148352,53480924
40400,2038683375,8270131,1.116467685e-12,1264005,149692,53630616
40450,2043441042,8268476,1.11624426e-12,1210238,147920,53778536
40500,2042346583,8278220,1.1175597e-12,1222359,148280,53926816
40550,2038147125,8269389,1.1163675150000001e-12,1239886,148424,54075240
40600,2051447625,8270262,1.1164853700000001e-12,1268286,148808,54224048
40650,2038616875,8271357,1.116633195e-12,1303844,150068,54374116
40700,2035620041,8270642,1.11653667e-12,1280620,149624,54523740
40750,2036143833,8280537,1.117872495e-12,1297646,149648,54673388
40800,2033592416,8271411,1.1166404850000001e-12,1305622,150068,54823456
40850,2039912333,8271099,1.116598365e-12,1295473,150140,54973596
40900,2001354667,8270601,1.116531135e-12,1279279,149680,55123276
40950,2614507041,8279634,1.11775059e-12,1268312,149324,55272600
41000,2282304958,8270105,1.116464175e-12,1263154,149340,55421940
41050,2225580417,8270331,1.116494685e-12,1270514,148868,55570808
41100,2038668542,8270081,1.116460935e-12,1262392,149036,55719844
41150,2041933625,8271120,1.1166012e-12,1296146,149192,55869036
41200,2041979625,8280602,1.11788127e-12,1299758,149576,56018612
41250,2037673292,8271712,1.11668112e-12,1315407,150044,56168656
41300,2053170584,8271286,1.11662361e-12,1301546,149504,56318160
41350,2034394500,8271273,1.116621855e-12,1301125,149552,56467712
41400,2036606667,8271584,1.11666384e-12,1311225,150016,56617728
41450,2047910458,8279089,1.117677015e-12,1250590,148424,56766152
41500,2040809542,8270258,1.11648483e-12,1268126,148688,56914840
41550,2036241292,8271498,1.11665223e-12,1308450,149876,57064716
41600,2038776625,8272042,1.11672567e-12,1326124,150020,57214736
41650,2037560583,8271004,1.11658554e-12,1292384,149600,57364336
41700,2034243958,8280173,1.117823355e-12,1285822,149600,57513936
41750,2036773333,8272194,1.11674619e-12,1331041,150580,57664516
41800,2135880458,8269746,1.11641571e-12,1251488,148464,57812980
41850,2283685708,8270327,1.1164941450000002e-12,1270383,149024,57962004
41900,2125104666,8281010,1.1179363499999999e-12,1313038,150092,58112096
41950,2223961125,8271178,1.11660903e-12,1298026,149576,58261672
42000,2053338792,8271326,1.11662901e-12,1302862,149964,58411636
42050,2049112000,8271318,1.1166279300000001e-12,1302600,149696,58561332
42100,2036497500,8271141,1.1166040349999999e-12,1296836,149672,58711004
42150,2052686000,8280496,1.11786696e-12,1296307,150064,58861068
42200,2051806833,8271134,1.11660309e-12,1296609,150116,59011184
42250,2037532667,8269605,1.1163966749999999e-12,1246922,148848,59160032
42300,2037044875,8270750,1.11655125e-12,1284123,149600,59309632
42350,2036498625,8271399,1.116638865e-12,1305240,150116,59459748
42400,2052977583,8280318,1.1178429300000001e-12,1290550,150092,59609840
42450,2031137334,8272135,1.116738225e-12,1329137,150796,59760636
42500,2032101500,8270435,1.116508725e-12,1273888,149240,59909876
42550,2035602708,8270774,1.11655449e-12,1284902,149264,60059140
42600,2055170625,8270534,1.1165220899999999e-12,1277110,149672,60208812
42650,2042953750,8279889,1.1177850149999999e-12,1276588,149576,60358388
42700,2119418083,8270782,1.1165555699999999e-12,1285152,149624,60508012
42750,2063023125,8270614,1.11653289e-12,1279708,149544,60657556
42800,2250817125,8271415,1.116641025e-12,1305750,150092,60807648
42850,2214864541,8280587,1.117879245e-12,1299287,150388,60958036
42900,2037542958,8269730,1.1164135500000001e-12,1251000,148784,61106820
42950,2037917042,8270582,1.11652857e-12,1278660,149624,61256444
43000,2036888042,8270662,1.11653937e-12,1281284,149504,61405948
43050,2038911709,8271116,1.11660066e-12,1296022,149504,61555452
43100,2034174292,8280271,1.1178365850000001e-12,1289006,149624,61705076
43150,2051112583,8271404,1.11663954e-12,1305387,149876,61854952
43200,2040874375,8270635,1.116535725e-12,1280402,149456,62004408
43250,2048798750,8270919,1.116574065e-12,1289618,149692,62154100
43300,2034342292,8270374,1.1165004900000001e-12,1271898,149192,62303292
43350,2031863667,8280320,1.1178432e-12,1290600,149600,62452892
43400,2054072334,8271679,1.116676665e-12,1314322,150092,62602984
43450,2054894625,8271194,1.11661119e-12,1298566,150020,62753004
43500,2052160584,8271126,1.1166020100000001e-12,1296356,149504,62902508
43550,2060673334,8271165,1.116607275e-12,1297602,149648,63052156
43600,2097852958,8280101,1.117813635e-12,1283480,150520,63202676
43650,2275223500,8270231,1.116481185e-12,1267264,149456,63352132
43700,2056051333,8270347,1.116496845e-12,1271032,149672,63501804
43750,2057770667,8270385,1.116501975e-12,1272264,149648,63651452
43800,2043025209,8279913,1.117788255e-12,1277358,150092,63801544
43850,2034878541,8270617,1.116533295e-12,1279818,149640,63951184
43900,2033979875,8270771,1.116554085e-12,1284805,150044,64101228
43950,2034164542,8271308,1.11662658e-12,1302257,150616,64251844
44000,2032526084,8270278,1.11648753e-12,1268792,149504,64401348
44050,2034073584,8281069,1.117944315e-12,1314933,149684,64551032
44100,2050404000,8270153,1.116470655e-12,1264730,148988,64700020
44150,2037072916,8269453,1.116376155e-12,1241985,149296,64849316
44200,2032216500,8269253,1.1163491550000001e-12,1235475,148736,64998052
44250,2034769541,8270741,1.116550035e-12,1283822,149744,65147796
44300,2039391834,8279897,1.117786095e-12,1276838,149744,65297540
44350,2030988875,8270676,1.11654126e-12,1281740,149996,65447536
44400,2032800667,8270656,1.11653856e-12,1281090,149648,65597184
44450,2047703291,8270586,1.11652911e-12,1278808,149696,65746880
44500,2218301708,8270628,1.11653478e-12,1280159,150268,65897148
44550,2375731959,8279463,1.1177275050000001e-12,1262754,148496,66045644
44600,2291402334,8270694,1.11654369e-12,1282308,149636,66195280
44650,2033802583,8271719,1.116682065e-12,1315640,149744,66345024
44700,2042578000,8271159,1.116606465e-12,1297424,150044,66495068
44750,2051445500,8280054,1.11780729e-12,1281947,149552,66644620
44800,2045328875,8271272,1.11662172e-12,1301102,150020,66794640
44850,2047711875,8270954,1.1165787900000001e-12,1290747,149896,66944536
44900,2040715042,8271331,1.116629685e-12,1303022,149696,67094232
44950,2036477167,8270716,1.11654666e-12,1283018,149352,67243584
45000,2038357166,8280234,1.1178315900000001e-12,1287808,149496,67393080
45050,2046674417,8271681,1.116676935e-12,1314376,150092,67543172
45100,2035070708,19673516,2.65592466e-12,1301080,-13888684,53654488
45150,2038142292,8271050,1.11659175e-12,1293898,150116,53804604
45200,2048701917,8271859,1.116700965e-12,1320165,150964,53955568
45250,2037272625,8282708,1.11816558e-12,1306384,150272,54105840
45300,2036352417,8272590,1.11679965e-12,1343920,150800,54256640
45350,2034717125,8272667,1.116810045e-12,1346434,151220,54407860
45400,2176816875,8272210,1.1167483500000001e-12,1331570,150800,54558660
45450,2359154708,8272500,1.1167875e-12,1340998,150872,54709532
45500,2201761083,8284119,1.118356065e-12,1352232,150824,54860356
45550,2162044500,8274160,1.1170116e-12,1394962,152820,55013176
45600,2037328416,8269509,1.116383715e-12,1243806,148616,55161792
45650,2046507084,8269722,1.11641247e-12,1250708,148592,55310384
45700,2053792625,8282581,1.118148435e-12,1302254,150068,55460452
45750,2044491917,8270978,1.11658203e-12,1291542,149600,55610052
45800,2048310042,8271654,1.11667329e-12,1313492,150188,55760240
45850,2043633250,8270795,1.1165573250000001e-12,1285608,149504,55909744
45900,2035800959,8270806,1.11655881e-12,1285965,149624,56059368
45950,2054632958,8282383,1.1181217050000001e-12,1295833,150188,56209556
46000,2039597667,8269569,1.116391815e-12,1245740,148616,56358172
46050,2052552667,8272202,1.11674727e-12,1331326,150140,56508312
46100,2035399083,8269132,1.1163328200000001e-12,1231558,147740,56656052
46150,2045571750,8270256,1.11648456e-12,1268067,148916,56804968
46200,2037660167,8281300,1.1179755e-12,1260624,148472,56953440
46250,2044068250,8269559,1.116390465e-12,1245416,148352,57101792
46300,2170659292,8270653,1.116538155e-12,1280969,148916,57250708
46350,2214253208,8270461,1.116512235e-12,1274742,148844,57399552
46400,2362774667,8281989,1.118068515e-12,1283031,149584,57549136
46450,2204219250,8270345,1.116496575e-12,1270954,149192,57698328
46500,2042915500,8270208,1.11647808e-12,1266515,148760,57847088
46550,2045705083,8270794,1.11655719e-12,1285574,149324,57996412
46600,2056608917,8268650,1.11626775e-12,1215888,147740,58144152
46650,2052088375,8280760,1.1179026e-12,1243088,148136,58292288
46700,2036699875,8270547,1.1165238450000001e-12,1277524,148940,58441228
46750,2042019959,8270367,1.116499545e-12,1271674,148916,58590144
46800,2053511917,8269650,1.11640275e-12,1248364,148400,58738544
46850,2035565083,8270131,1.116467685e-12,1264024,148868,58887412
46900,2033861542,8280345,1.117846575e-12,1229583,148184,59035596
46950,2032384959,8268456,1.11624156e-12,1209574,147560,59183156
47000,2031827708,8269036,1.11631986e-12,1228433,147944,59331100
47050,2032302500,8269794,1.11642219e-12,1253080,148448,59479548
47100,2035499917,8269300,1.1163555000000001e-12,1237012,148496,59628044
47150,2037927625,8280747,1.117900845e-12,1242648,148868,59776912
47200,2451911542,8268686,1.11627261e-12,1217056,148280,59925192
47250,2244271333,8270102,1.11646377e-12,1263089,149612,60074804
47300,2252681041,8267550,1.11611925e-12,1180136,147200,60222004
47350,2047765875,8278962,1.11765987e-12,1184644,147608,60369612
47400,2044882834,8269238,1.11634713e-12,1234972,148676,60518288
47450,2031393875,8269236,1.11634686e-12,1234932,148352,60666640
47500,2038210959,8269105,1.116329175e-12,1230676,148400,60815040
47550,2046634958,8270474,1.11651399e-12,1275164,148232,60963272
47600,2036437625,8280519,1.1178700650000001e-12,1235244,148352,61111624
47650,2048443083,8268539,1.116252765e-12,1212277,148504,61260128
47700,2038156875,8269647,1.116402345e-12,1248278,148796,61408924
47750,2052217500,8268031,1.116184185e-12,1195752,147656,61556580
47800,2039420542,8268999,1.116314865e-12,1227224,148700,61705280
47850,2040103125,8280167,1.117822545e-12,1223824,148400,61853680
47900,2042372917,8269839,1.116428265e-12,1254520,148988,62002668
47950,2041471125,8268774,1.11628449e-12,1219914,148328,62150996
48000,2038870083,8268559,1.116255465e-12,1212939,148552,62299548
48050,2234028542,8270788,1.11655638e-12,1285378,148628,62448176
48100,2222498916,8280763,1.1179030049999999e-12,1243194,148748,62596924
48150,2398811834,8268721,1.1162773350000001e-12,1218186,148376,62745300
48200,2219389583,8268718,1.11627693e-12,1218108,148280,62893580
48250,2037630166,8269175,1.116338625e-12,1232944,148448,63042028
48300,2038786584,8280062,1.11780837e-12,1220404,148424,63190452
48350,2036403791,8269079,1.116325665e-12,1229832,148424,63338876
48400,2036973334,8268826,1.11629151e-12,1221581,148732,63487608
48450,2032270708,8267817,1.116155295e-12,1188792,147240,63634848
48500,2040049583,8269486,1.11638061e-12,1243052,148472,63783320
48550,2041299959,8281468,1.11799818e-12,1266104,148304,63931624
48600,2041630083,8269054,1.1163222899999999e-12,1229007,148352,64079976
48650,2039887875,8269278,1.11635253e-12,1236284,148304,64228280
48700,2048084500,8269648,1.11640248e-12,1248312,148376,64376656
48750,2041474834,8269179,1.1163391650000001e-12,1233076,148448,64525104
48800,2043065375,8280373,1.1178503550000002e-12,1230519,148408,64673512
48850,2051523708,8269622,1.11639897e-12,1247484,148772,64822284
48900,2040685292,8269650,1.11640275e-12,1248384,148892,64971176
48950,2125611000,8269566,1.1163914100000001e-12,1245662,148352,65119528
49000,2093327250,8269742,1.11641517e-12,1251358,148916,65268444
49050,2093926500,8280611,1.117882485e-12,1238260,148352,65416796
49100,2276289083,8269911,1.116437985e-12,1256861,148352,65565148
49150,2044396750,8268989,1.116313515e-12,1226887,148708,65713856
49200,2034020167,8268773,1.116284355e-12,1219876,147896,65861752
49250,2033041667,8280841,1.1179135350000001e-12,1245716,148496,66010248
49300,2031884542,8269552,1.11638952e-12,1245185,148964,66159212
49350,2051519041,8269346,1.11636171e-12,1238482,148472,66307684
49400,2032917709,8269540,1.1163879e-12,1244818,148940,66456624
49450,2041065709,8270397,1.116503595e-12,1272657,149620,66606244
49500,2033995584,8279260,1.1177001e-12,1194332,147716,66753960
49550,2037935709,8268329,1.116224415e-12,1205452,147936,66901896
49600,2035209792,8267804,1.11615354e-12,1188378,147788,67049684
49650,2037600959,8267301,1.116085635e-12,1172030,147344,67197028
49700,2030949958,8268013,1.116181755e-12,1195186,147932,67344960
49750,2039848333,8278519,1.117600065e-12,1170250,147488,67492448
49800,2173160791,8268815,1.1162900249999999e-12,1221259,148600,67641048
49850,2250761125,8268122,1.1161964700000002e-12,1198709,147884,67788932
49900,2435976750,8268769,1.1162838149999999e-12,1219758,148076,67937008
49950,2257922083,8278930,1.1176555500000002e-12,1183612,147320,68084328
50000,2049255875,8267896,1.11616596e-12,1191390,147836,68232164
50050,2047671000,8277579,1.117473165e-12,1290556,148836,68381000
50100,2047192417,8278934,1.11765609e-12,1334590,149712,68530712
50150,2047894625,8279065,1.117673775e-12,1338856,149676,68680388
50200,2057818666,8289778,1.11912003e-12,1320644,149652,68830040
50250,2053505542,8278487,1.1175957450000001e-12,1320058,149676,68979716
50300,2047186584,8278664,1.1176196400000002e-12,1325816,150088,69129804
50350,2044469000,8278928,1.11765528e-12,1334383,149948,69279752
50400,2048782250,8278207,1.117557945e-12,1310970,149076,69428828
50450,2035553333,8288127,1.118897145e-12,1267000,148476,69577304
50500,2042879666,8278749,1.117631115e-12,1328588,149784,69727088
50550,2052108667,8279228,1.11769578e-12,1344136,149700,69876788
50600,2038322375,8279447,1.117725345e-12,1351266,150232,70027020
50650,2034383958,8278618,1.1176134300000001e-12,1324328,149628,70176648
50700,2175027459,8291290,1.11932415e-12,1369789,150944,70327592
50750,2166277334,8279347,1.117711845e-12,1348002,150060,70477652
50800,2265854833,8280050,1.11780675e-12,1370866,150852,70628504
50850,2372118000,8280002,1.11780027e-12,1369308,150828,70779332
50900,2217036000,8291490,1.11935115e-12,1376272,150876,70930208
50950,2040965958,8281203,1.117962405e-12,1408326,151464,71081672
51000,2035100833,8281120,1.1179512e-12,1405646,151440,71233112
51050,2034207375,8280681,1.117891935e-12,1391354,150852,71383964
51100,2037063958,8279776,1.1177697600000001e-12,1361950,151256,71535220
51150,2057267042,8290221,1.119179835e-12,1335040,150084,71685304
51200,2049620833,8279768,1.11776868e-12,1361690,150756,71836060
51250,2047328125,8279997,1.117799595e-12,1369131,150780,71986840
51300,2039679834,8280411,1.1178554850000001e-12,1382588,151416,72138256
51350,2048578584,8279460,1.1177271e-12,1351684,150732,72288988
51400,2036545708,8291787,1.119391245e-12,1385932,151464,72440452
51450,2034390625,8279851,1.117779885e-12,1364401,150908,72591360
51500,2033244167,8278746,1.11763071e-12,1328462,149988,72741348
51550,2033679292,8279878,1.11778353e-12,1365256,150556,72891904
51600,2045024000,8279458,1.11772683e-12,1351616,151176,73043080
51650,2173399000,8290850,1.1192647500000001e-12,1355494,150900,73193980
51700,2115736708,8279293,1.117704555e-12,1346266,150828,73344808
51750,2201792666,8279635,1.117750725e-12,1357372,151344,73496152
51800,2207287917,8280369,1.117849815e-12,1381239,151868,73648020
51850,2037201791,8290332,1.11919482e-12,1338662,150516,73798536
51900,2037041042,8280394,1.11785319e-12,1382050,151392,73949928
51950,2036193125,8279752,1.11776652e-12,1361176,150900,74100828
52000,2040635334,8279759,1.117767465e-12,1361404,150924,74251752
52050,2034633250,8279920,1.1177892e-12,1366634,150108,74401860
52100,2043374666,8290070,1.1191594500000001e-12,1330146,149940,74551800
52150,2037181167,8280250,1.11783375e-12,1377344,150876,74702676
52200,2037188125,8280662,1.11788937e-12,1390742,151296,74853972
52250,2050171250,8280177,1.117823895e-12,1374976,150900,75004872
52300,2059203084,8279998,1.11779973e-12,1369180,150876,75155748
52350,2044520417,8291958,1.1194143299999999e-12,1391508,151312,75307060
52400,2036925750,8280945,1.117927575e-12,1399944,152060,75459120
52450,2034150208,8278474,1.1175939899999999e-12,1319650,149676,75608796
52500,2039778500,8280197,1.1178265950000001e-12,1375634,150684,75759480
52550,2199648958,8280776,1.1179047600000001e-12,1394460,151248,75910728
52600,2326315209,8292107,1.1194344450000001e-12,1396340,151368,76062096
52650,2192314750,8280503,1.117867905e-12,1385572,150876,76212972
52700,2035685375,8280637,1.117885995e-12,1389932,150900,76363872
52750,2049195750,8281454,1.11799629e-12,1416509,152072,76515944
52800,2041755125,8290728,1.11924828e-12,1351525,150240,76666184
52850,2038231916,8280006,1.11780081e-12,1369437,150672,76816856
52900,2038602584,8279830,1.11777705e-12,1363716,150804,76967660
52950,2037794417,8280933,1.117925955e-12,1399542,151272,77118932
53000,2031246958,8279900,1.1177865e-12,1365982,150844,77269776
53050,2045471458,8292193,1.119446055e-12,1399134,151272,77421048
53100,2035644166,8279606,1.11774681e-12,1356441,150812,77571860
53150,2040679500,8279965,1.117795275e-12,1368088,150708,77722568
53200,2031421584,8280410,1.11785535e-12,1382564,150876,77873444
53250,2032369959,8280142,1.11781917e-12,1373870,150876,78024320
53300,2030842208,8291630,1.1193700500000001e-12,1380848,150828,78175148
53350,2031534750,8280031,1.117804185e-12,1370242,150780,78325928
53400,2048386875,8280390,1.11785265e-12,1381916,150876,78476804
53450,2090781958,8280262,1.1178353700000001e-12,1377760,150852,78627656
53500,2406268833,8291736,1.11938436e-12,1384283,151268,78778924
53550,2186885958,8280467,1.117863045e-12,1384422,150840,78929764
53600,2038732959,8278198,1.11755673e-12,1310678,149652,79079416
53650,2029536417,8280038,1.11780513e-12,1370488,151272,79230688
53700,2043776042,8279940,1.1177919000000001e-12,1367272,150876,79381564
53750,2033343459,8290839,1.119263265e-12,1355138,150948,79532512
53800,2032857875,8279647,1.117752345e-12,1357762,150972,79683484
53850,2031432167,8281074,1.11794499e-12,1404155,152168,79835652
53900,2050078667,8279364,1.11771414e-12,1348570,150292,79985944
53950,2039576375,8278345,1.117576575e-12,1315456,149724,80135668
54000,2034357709,8291140,1.1193039e-12,1364914,150672,80286340
54050,2036595375,8280967,1.117930545e-12,1400660,151224,80437564
54100,2054613000,8281175,1.117958625e-12,1407424,151392,80588956
54150,2035136875,8280683,1.117892205e-12,1391450,151320,80740276
54200,2032478500,8279868,1.11778218e-12,1364935,150908,80891184
54250,2030821750,8290180,1.1191743e-12,1333730,150124,81041308
54300,2057505334,8279789,1.117771515e-12,1362382,150708,81192016
54350,2026809208,8279870,1.11778245e-12,1365028,150828,81342844
54400,2528390625,8279780,1.1177703e-12,1362077,150828,81493672
54450,6921882167,22060699,2.978194365e-12,1379860,-16714512,64779160
54500,2062401250,8279763,1.117768005e-12,1361542,150852,64930012
54550,2043688542,8279964,1.1177951399999999e-12,1368054,150804,65080816
54600,2033074833,8293121,1.119571335e-12,1355301,150884,65231700
54650,2034549958,8279279,1.117702665e-12,1345814,150396,65382096
54700,2033808167,8279298,1.11770523e-12,1346434,150492,65532588
54750,2046240750,8280453,1.117861155e-12,1383966,151344,65683932
54800,2048733750,8279814,1.1177748900000001e-12,1363190,150756,65834688
54850,2053547000,8293274,1.11959199e-12,1360268,150780,65985468
54900,2040328750,8280339,1.117845765e-12,1380250,151200,66136668
54950,2040123542,8280659,1.1178889650000001e-12,1390657,151544,66288212
55000,2037537417,8279340,1.1177109e-12,1347794,150228,66438440
55050,2033442292,8280712,1.11789612e-12,1392382,151296,66589736
55100,2033735458,8280087,1.117811745e-12,1372060,150688,66740424
55150,2038275125,8280822,1.1179109700000001e-12,1395966,151296,66891720
55200,2088311875,8280485,1.117865475e-12,1384990,150900,67042620
55250,2414534333,8280680,1.1178918e-12,1391336,150828,67193448
55300,2171428625,8294324,1.1197337400000002e-12,1394374,150972,67344420
55350,2169453833,8280279,1.117837665e-12,1378314,150900,67495320
55400,2034881875,8281131,1.117952685e-12,1406003,151508,67646828
55450,2062431375,8279012,1.11766662e-12,1337124,149556,67796384
55500,2040250417,8280617,1.117883295e-12,1389294,150516,67946900
55550,2046224917,8294420,1.1197467e-12,1397504,150820,68097720
55600,2040931208,8279953,1.117793655e-12,1367707,150876,68248596
55650,2044634333,8279805,1.117773675e-12,1362888,150924,68399520
55700,2033164000,8279710,1.11776085e-12,1359814,150828,68550348
55750,2049973500,8279976,1.11779676e-12,1368456,150804,68701152
55800,2044436583,8293371,1.119605085e-12,1363426,150852,68852004
55850,2033914542,8280111,1.117814985e-12,1372847,151136,69003140
55900,2033563708,8279455,1.117726425e-12,1351524,150312,69153452
55950,2035489166,8280352,1.11784752e-12,1380670,151012,69304464
56000,2043525000,8294348,1.11973698e-12,1395166,151344,69455808
56050,2056395917,8280735,1.1178992249999999e-12,1393112,151416,69607224
56100,2049331875,8279971,1.117796085e-12,1368298,150924,69758148
56150,2132461833,8279921,1.1177893350000001e-12,1366672,151468,69909616
56200,2526441125,8277160,1.1174166e-12,1276940,148980,70058596
56250,2285753666,8292311,1.119461985e-12,1328954,150096,70208692
56300,2034240834,8278384,1.11758184e-12,1316728,149700,70358392
56350,2042876292,8278450,1.1175907500000001e-12,1318868,149748,70508140
56400,2031411708,8278492,1.11759642e-12,1320238,150264,70658404
56450,2032222417,8292012,1.11942162e-12,1319256,149796,70808200
56500,2031383709,8278449,1.117590615e-12,1318830,149748,70957948
56550,2040830417,8279408,1.11772008e-12,1349989,150104,71108052
56600,2033355584,8277880,1.1175138000000001e-12,1300348,149148,71257200
56650,2052559542,8277527,1.117466145e-12,1288879,149496,71406696
56700,2033973541,8291340,1.1193309e-12,1297417,149532,71556228
56750,2048342791,8277725,1.117492875e-12,1295304,149604,71705832
56800,2033746541,8277670,1.1174854500000001e-12,1293496,149700,71855532
56850,2044087250,8278109,1.117544715e-12,1307789,150048,72005580
56900,2057177125,8278402,1.11758427e-12,1317317,149972,72155552
56950,2065576792,8291611,1.119367485e-12,1306208,149652,72305204
57000,2042256958,8277023,1.117398105e-12,1272488,149224,72454428
57050,2320974459,8279860,1.1177811e-12,1364674,149532,72603960
57100,6677330666,8293075,1.119565125e-12,1309744,149604,72753564
57150,2048269708,8277931,1.117520685e-12,1301984,149676,72903240
57200,2034822667,8278383,1.117581705e-12,1316691,150024,73053264
57250,2051590709,8278964,1.1176601400000001e-12,1335575,150492,73203756
57300,2035971500,8278399,1.117583865e-12,1317210,149892,73353648
57350,2036733666,8294008,1.11969108e-12,1384118,151416,73505064
57400,2044447250,8280164,1.11782214e-12,1374556,150876,73655940
57450,2032259916,8280097,1.117813095e-12,1372382,151320,73807260
57500,2033780583,8280456,1.11786156e-12,1384052,151392,73958652
57550,2037995667,8281013,1.117936755e-12,1402157,151368,74110020
57600,2041978292,8292264,1.11945564e-12,1327445,149984,74260004
57650,2042107750,8279252,1.1176990200000002e-12,1344919,150072,74410076
57700,2032402083,8278999,1.117664865e-12,1336707,150168,74560244
57750,2036902917,8278306,1.11757131e-12,1314184,149604,74709848
57800,2042039375,8278681,1.117621935e-12,1326358,149652,74859500
57850,2048390791,8292325,1.119463875e-12,1329440,150072,75009572
57900,2056877000,8279425,1.117722375e-12,1350539,150896,75160468
57950,2186095791,8279973,1.1177963549999999e-12,1368360,150516,75310984
58000,2355218708,8280814,1.11790989e-12,1395688,151344,75462328
58050,2222696500,8294877,1.119808395e-12,1412360,151320,75613648
58100,2047956708,8279957,1.117794195e-12,1367840,150900,75764548
58150,2033703250,8279948,1.11779298e-12,1367536,151344,75915892
58200,2033963084,8279486,1.11773061e-12,1352526,150660,76066552
58250,2035513834,8279552,1.11773952e-12,1354683,150812,76217364
58300,2036008334,8291744,1.11938544e-12,1310544,149652,76367016
58350,2031025333,8280339,1.117845765e-12,1380268,151296,76518312
58400,2047936416,8279667,1.117755045e-12,1358422,150828,76669140
58450,2040369583,8279989,1.117798515e-12,1368864,150900,76820040
58500,2038063000,8280007,1.117800945e-12,1369458,151296,76971336
58550,2037761084,8293791,1.119661785e-12,1377054,150660,77121996
58600,2060014542,8278337,1.117575495e-12,1315200,149716,77271712
58650,2032164292,8280810,1.11790935e-12,1395570,151296,77423008
58700,2033338458,8280261,1.117835235e-12,1377704,150732,77573740
58750,2038771333,8280412,1.1178556200000001e-12,1382634,150924,77724664
58800,2087227542,8294177,1.119713895e-12,1389602,151176,77875840
58850,2399796458,8280933,1.117925955e-12,1399560,151288,78027128
58900,2384516250,8280970,1.11793095e-12,1400741,151172,78178300
58950,2383869292,8280025,1.117803375e-12,1370042,150696,78328996
59000,2037777875,8293290,1.11959415e-12,1360778,150348,78479344
59050,2038632583,8280216,1.11782916e-12,1376250,150480,78629824
59100,2019059667,8280235,1.117831725e-12,1376890,150384,78780208
59150,2047078833,8280149,1.117820115e-12,1374078,150628,78930836
59200,2038402916,8280944,1.1179274400000001e-12,1399922,151344,79082180
59250,2048182333,8294139,1.119708765e-12,1388368,150772,79232952
59300,2037283792,8280656,1.11788856e-12,1390554,150852,79383804
59350,2033253458,8280908,1.11792258e-12,1398756,151224,79535028
59400,2045098709,8280567,1.117876545e-12,1387680,151264,79686292
59450,2034557583,8279616,1.11774816e-12,1356754,150184,79836476
59500,2045621458,8293935,1.119681225e-12,1381736,150660,79987136
59550,2034731583,8280664,1.1178896400000001e-12,1390825,150852,80137988
59600,2034714250,8279930,1.11779055e-12,1366980,150780,80288768
59650,2031606167,8280791,1.117906785e-12,1394932,151296,80440064
59700,2062382750,8279670,1.11775545e-12,1358492,150780,80590844
59750,2099339583,8294892,1.11981042e-12,1412869,151952,80742796
59800,2298911500,8278368,1.11757968e-12,1316188,149628,80892424
59850,2143635375,8281065,1.117943775e-12,1403860,151296,81043720
59900,2138765542,8280446,1.11786021e-12,1383748,150844,81194564
59950,2039907500,8294013,1.119691755e-12,1384286,151344,81345908
60000,2035446500,8280057,1.1178076950000001e-12,1371077,150748,81496656
60050,2041575708,8280823,1.1179111050000001e-12,1395986,151344,81648000
60100,2044166292,8280607,1.117881945e-12,1388957,151364,81799364
60150,2038050625,8279374,1.11771549e-12,1348872,150288,81949652
60200,2031215083,8293618,1.11963843e-12,1371450,150708,82100360
60250,2045565875,8280768,1.11790368e-12,1394202,151248,82251608
60300,2044591250,8280359,1.117848465e-12,1380918,150924,82402532
60350,2032073458,8279962,1.11779487e-12,1368016,150924,82553456
60400,2034011666,8280287,1.117838745e-12,1378562,151296,82704752
60450,2050947958,8294414,1.1197458900000001e-12,1397313,151484,82856236
60500,2034903875,8279366,1.1177144099999999e-12,1348614,150264,83006500
60550,2025942125,8280233,1.117831455e-12,1376804,151008,83157508
60600,2038092916,8280425,1.117857375e-12,1383042,150876,83308384
60650,2058076833,8293917,1.119678795e-12,1381164,150876,83459260
60700,2151897875,8280124,1.11781674e-12,1373276,150828,83610088
60750,2353528166,8280324,1.11784374e-12,1379756,150900,83760988
60800,2016480417,8280143,1.117819305e-12,1373874,150852,83911840
60850,2016549917,8279740,1.1177649e-12,1360779,150644,84062484
60900,2032487625,8293680,1.1196468000000002e-12,1373458,151056,84213540
60950,2038710708,8281099,1.117948365e-12,1404944,150972,84364512
61000,2032812542,8280869,1.1179173150000001e-12,1397478,150756,84515268
61050,2036236167,8280783,1.117905705e-12,1394682,150796,84666064
61100,2035617166,8280536,1.11787236e-12,1386648,150988,84817052
61150,2042602750,8294362,1.1197388700000001e-12,1395620,151248,84968300
61200,2037778875,8280209,1.117828215e-12,1376031,151140,85119440
61250,2055317125,8279557,1.1177401950000001e-12,1354848,150132,85269572
61300,2038611875,8279804,1.1177735400000001e-12,1362880,150444,85420016
61350,2046712167,8279995,1.117799325e-12,1369074,150828,85570844
61400,2035337916,8293674,1.11964599e-12,1373258,150852,85721696
61450,2034732667,8280566,1.1178764100000001e-12,1387613,151248,85872944
61500,2033791417,8280272,1.11783672e-12,1378074,150844,86023788
61550,2151644541,8281377,1.117985895e-12,1413994,150876,86174664
61600,2149438958,8292248,1.11945348e-12,1326924,149796,86324460
61650,2438016000,8280386,1.11785211e-12,1381786,150876,86475336
61700,2376402500,8280604,1.11788154e-12,1388878,151288,86626624
61750,2270401000,8280306,1.11784131e-12,1379188,150900,86777524
61800,2037118625,8294333,1.119734955e-12,1394694,151392,86928916
61850,2033576541,8280584,1.1178788400000001e-12,1388222,151320,87080236
61900,2033472875,8280432,1.11785832e-12,1383287,151220,87231456
61950,2031734583,8279731,1.117763685e-12,1360482,150324,87381780
62000,2040665583,8279912,1.1177881200000001e-12,1366382,150372,87532152
62050,2043035083,8293304,1.11959604e-12,1361232,150276,87682428
62100,2033088666,8278120,1.1175462e-12,1308130,149668,87832096
62150,2051234917,8279386,1.11771711e-12,1349295,150396,87982492
62200,2039327416,8279981,1.117797435e-12,1368618,150660,88133152
62250,2039261417,8280447,1.117860345e-12,1383776,150780,88283932
62300,2032624542,8294625,1.119774375e-12,1404188,151368,88435300
62350,2033670875,8279758,1.1177673300000001e-12,1361357,150828,88586128
62400,2038389708,8279950,1.11779325e-12,1367614,150900,88737028
62450,2041933042,8280354,1.11784779e-12,1380751,151556,88888584
62500,2056783125,8291824,1.11939624e-12,1313128,149604,89038188
62550,2089242417,8279278,1.11770253e-12,1345784,150348,89188536
62600,2269778000,8280316,1.11784266e-12,1379514,150708,89339244
62650,2016690833,8280549,1.117874115e-12,1387066,151344,89490588
62700,2042811542,8280587,1.117879245e-12,1388306,150804,89641392
62750,2063521291,8294073,1.119699855e-12,1386234,151296,89792688
62800,2042330041,8280062,1.11780837e-12,1371258,150756,89943444
62850,2042899333,8280339,1.117845765e-12,1380262,151232,90094676
62900,2045379375,8279784,1.11777084e-12,1362218,150300,90244976
62950,2036451125,8293981,1.119687435e-12,1383244,150900,90395876
63000,2035254750,8280672,1.11789072e-12,1391070,151272,90547148
63050,2043181583,8280982,1.11793257e-12,1401166,150796,90697944
63100,2037751375,8280631,1.1178851850000001e-12,1389740,150948,90848892
63150,2045580042,8279582,1.11774357e-12,1355648,150916,90999808
63200,2052267875,8293801,1.119663135e-12,1377394,151876,91151684
63250,2035612375,8279530,1.11773655e-12,1353964,151200,91302884
63300,2032216000,8278487,1.1175957450000001e-12,1320074,150180,91453064
63350,2048332666,8279505,1.117733175e-12,1353136,150684,91603748
63400,2046076875,8279646,1.1177522100000001e-12,1357744,151248,91754996
63450,2138792333,8292632,1.11950532e-12,1339402,150780,91905776
63500,2116886709,8279821,1.117775835e-12,1363422,151320,92057096
63550,2518647541,8281285,1.117973475e-12,1411005,151268,92208364
63600,2022424625,8278698,1.11762423e-12,1326906,150128,92358492
63650,2043197750,8293493,1.119621555e-12,1367390,150540,92509032
63700,2047906416,8280426,1.1178575100000001e-12,1383078,150876,92659908
63750,2044337833,8280314,1.1178423899999999e-12,1379444,150732,92810640
63800,2053459500,8280469,1.117863315e-12,1384486,150924,92961564
63850,2044381333,8280004,1.11780054e-12,1369372,151320,93112884
63900,2037112792,8293922,1.11967947e-12,1381326,150948,93263832
63950,2054715292,8280544,1.11787344e-12,1386915,151028,93414860
64000,2040381500,8279164,1.11768714e-12,1342054,149604,93564464
64050,2047019000,8280999,1.117934865e-12,1401715,150852,93715316
64100,2038642417,8279695,1.117758825e-12,1359324,150844,93866160
64150,2046872625,8294116,1.1197056599999999e-12,1387628,150948,94017108
64200,2051221916,8279526,1.11773601e-12,1353838,150780,94167888
64250,2049478292,8279908,1.1177875799999999e-12,1366234,150828,94318716
64300,2038522083,8280482,1.1178650700000001e-12,1384900,151320,94470036
64350,2114414166,8280396,1.11785346e-12,1382093,150908,94620944
64400,2314834084,8293494,1.11962169e-12,1367404,150612,94771556
64450,2420356959,8280858,1.11791583e-12,1397134,151248,94922804
64500,2038758125,8279923,1.117789605e-12,1366729,150852,95073656
64550,2033763125,8281382,1.11798657e-12,1414134,150900,95224556
64600,2042850833,8293416,1.11961116e-12,1364900,150852,95375408
64650,2044627541,8280245,1.117833075e-12,1377210,150972,95526380
64700,2054066834,8280342,1.11784617e-12,1380364,150900,95677280
64750,2045039167,8281557,1.118010195e-12,1419839,152012,95829292
64800,2037757459,8281132,1.11795282e-12,1406026,151212,95980504
64850,2032580500,8295676,1.11991626e-12,1438330,152076,96132580
64900,2049004375,8282069,1.118079315e-12,1436462,151996,96284576
64950,2032873042,8281880,1.1180538e-12,1430328,152076,96436652
65000,2049446750,8281907,1.118057445e-12,1431230,152052,96588704
65050,2043092542,8282146,1.11808971e-12,1438968,152052,96740756
65100,2031498083,8295292,1.11986442e-12,1425856,151968,96892724
65150,2040541417,8281861,1.118051235e-12,1429710,152304,97045028
65200,2093024459,8281803,1.118043405e-12,1427832,152196,97197224
65250,2090775250,8282225,1.118100375e-12,1441560,152496,97349720
65300,2240617958,8281269,1.117971315e-12,1410486,152196,97501916
65350,2228402750,8295035,1.119829725e-12,1417492,152124,97654040
65400,2190291458,8280816,1.11791016e-12,1395759,151868,97805908
65450,2063565500,8281428,1.11799278e-12,1415656,151992,97957900
65500,2033873125,8281573,1.118012355e-12,1420352,151692,98109592
65550,2032390333,8295385,1.119876975e-12,1428874,151932,98261524
65600,3249505667,24867075,3.3570551250000003e-12,1427580,-20218468,78043056
65650,2037671917,8281565,1.118011275e-12,1420104,152028,78195084
65700,2047207125,8281954,1.11806379e-12,1432742,152496,78347580
65750,2039545084,8298283,1.120268205e-12,1434313,152636,78500216
65800,2040677458,8280706,1.11789531e-12,1392176,151416,78651632
65850,2034548334,8281928,1.11806028e-12,1431884,152108,78803740
65900,2053599959,8281614,1.11801789e-12,1421676,152052,78955792
65950,2038189375,8281698,1.11802923e-12,1424405,152004,79107796
66000,2048847375,8298214,1.12025889e-12,1432050,152052,79259848
66050,2049230667,8281883,1.118054205e-12,1430450,152044,79411892
66100,2054823875,8282708,1.11816558e-12,1457240,152188,79564080
66150,2040638625,8281458,1.1179968300000001e-12,1416611,152324,79716404
66200,2124845917,8282060,1.1180781e-12,1436174,152424,79868828
66250,2086152208,8296955,1.120088925e-12,1391124,151620,80020448
66300,2280406667,8280727,1.117898145e-12,1392862,151740,80172188
66350,2042386375,8282125,1.118086875e-12,1438306,152592,80324780
66400,2032750583,8281468,1.11799818e-12,1416952,152076,80476856
66450,2041955916,8298229,1.120260915e-12,1432554,152496,80629352
66500,2047548958,8281660,1.1180241e-12,1423177,152444,80781796
66550,2049692792,8281374,1.1179854900000001e-12,1413892,151524,80933320
66600,2061100875,8282046,1.1180762100000001e-12,1435742,151932,81085252
66650,2053681542,8281794,1.11804219e-12,1427531,152124,81237376
66700,2039500209,8298581,1.120308435e-12,1443973,152172,81389548
66750,2042459958,8282061,1.118078235e-12,1436226,152520,81542068
66800,2033497500,8282330,1.11811455e-12,1444942,152520,81694588
66850,2039934959,8281667,1.118025045e-12,1423420,152028,81846616
66900,2031674375,8281615,1.118018025e-12,1421731,152052,81998668
66950,2037323666,8297147,1.120114845e-12,1397400,151396,82150064
67000,2039386542,8281868,1.11805218e-12,1429948,152052,82302116
67050,2042077375,8281784,1.11804084e-12,1427226,151932,82454048
67100,2059768875,8281919,1.118059065e-12,1431614,152172,82606220
67150,2182073833,8281947,1.118062845e-12,1432524,152520,82758740
67200,2140922042,8298225,1.120260375e-12,1432430,152124,82910864
67250,2249693708,8282504,1.1181380400000001e-12,1450621,153128,83063992
67300,2043093500,8280447,1.117860345e-12,1383758,151464,83215456
67350,2056583333,8281536,1.11800736e-12,1419150,152076,83367532
67400,2041979250,8297659,1.120183965e-12,1414024,152076,83519608
67450,2053157334,8281506,1.11800331e-12,1418196,152148,83671756
67500,2042419000,8281654,1.11802329e-12,1422992,152068,83823824
67550,2035738459,8282047,1.118076345e-12,1435772,152092,83975916
67600,2032147792,8281177,1.117958895e-12,1407474,152544,84128460
67650,2051800083,8296754,1.12006179e-12,1384609,152084,84280544
67700,2034083833,8279553,1.117739655e-12,1354695,150948,84431492
67750,2060359667,8280579,1.117878165e-12,1388058,151740,84583232
67800,2034508250,8281440,1.1179944e-12,1416028,152512,84735744
67850,2032940833,8281212,1.11796362e-12,1408628,152148,84887892
67900,2032857417,8297691,1.120188285e-12,1415070,152520,85040412
67950,2031816250,8281505,1.118003175e-12,1418136,152100,85192512
68000,2038345292,8281417,1.117991295e-12,1415273,152396,85344908
68050,2245131500,8282030,1.11807405e-12,1435208,151848,85496756
68100,2243016333,8279873,1.117782855e-12,1365120,150948,85647704
68150,2129485208,8298033,1.120234455e-12,1426188,152100,85799804
68200,2237898042,8281617,1.118018295e-12,1421782,152472,85952276
68250,2043239333,8281250,1.11796875e-12,1409872,151980,86104256
68300,2033263000,8281271,1.1179715850000001e-12,1410542,152172,86256428
68350,2033946583,8298038,1.1202351300000001e-12,1426328,152520,86408948
68400,2031353875,8281660,1.1180241e-12,1423183,152564,86561512
68450,2051084083,8280570,1.11787695e-12,1387762,151236,86712748
68500,2046292666,8280509,1.117868715e-12,1385782,151608,86864356
68550,2034845417,8281051,1.117941885e-12,1403386,151368,87015724
68600,2034032250,8297967,1.120225545e-12,1424014,152208,87167932
68650,2031565125,8282328,1.11811428e-12,1444910,152592,87320524
68700,2059943334,8281414,1.11799089e-12,1415186,151956,87472480
68750,2031909541,8281871,1.118052585e-12,1430040,152076,87624556
68800,2032966083,8282033,1.118074455e-12,1435306,152124,87776680
68850,2042777500,8297913,1.1202182549999999e-12,1422282,152172,87928852
68900,2036842042,8281062,1.11794337e-12,1403763,152280,88081132
68950,2308567666,8281344,1.11798144e-12,1412906,151668,88232800
69000,2273058042,8281609,1.118017215e-12,1421538,151924,88384724
69050,2427117416,8282114,1.11808539e-12,1437934,152196,88536920
69100,2044546000,8297766,1.12019841e-12,1417496,152544,88689464
69150,2059457875,8280811,1.117909485e-12,1395586,152052,88841516
69200,2038626708,8281142,1.11795417e-12,1406370,152448,88993964
69250,2038944083,8280614,1.11788289e-12,1389191,151988,89145952
69300,2035120750,8279550,1.11773925e-12,1354594,150900,89296852
69350,2048924917,8297433,1.120153455e-12,1406661,152328,89449180
69400,2045906083,8281216,1.11796416e-12,1408748,151956,89601136
69450,2032281000,8280918,1.11792393e-12,1399090,152028,89753164
69500,2038642458,8281168,1.11795768e-12,1407200,152376,89905540
69550,2037109791,8282780,1.1181753000000001e-12,1459576,152020,90057560
69600,2040015667,8297400,1.120149e-12,1405607,152324,90209884
69650,2055865500,8280830,1.11791205e-12,1396196,151884,90361768
69700,2035798708,8280741,1.117900035e-12,1393324,151944,90513712
69750,2060159291,8280855,1.117915425e-12,1397034,151860,90665572
69800,2162728375,8297469,1.1201583150000001e-12,1407832,152052,90817624
69850,2209954958,8280937,1.117926495e-12,1399696,152424,90970048
69900,2318201959,8281133,1.117952955e-12,1406064,151956,91122004
69950,2399371833,8280881,1.117918935e-12,1397866,151980,91273984
70000,2203456667,8281108,1.11794958e-12,1405259,152680,91426664
70050,2042534583,8296537,1.120032495e-12,1377564,150324,91576988
70100,2066080959,8280027,1.117803645e-12,1370128,150972,91727960
70150,2042508042,8280611,1.117882485e-12,1389108,151464,91879424
70200,2046939583,8280095,1.117812825e-12,1372318,151368,92030792
70250,2061594959,8279343,1.117711305e-12,1347895,150780,92181572
70300,2047117292,8295767,1.119928545e-12,1352524,150900,92332472
70350,2038398542,8281401,1.117989135e-12,1414775,152288,92484760
70400,2056393416,8281415,1.117991025e-12,1415238,152052,92636812
70450,2036424625,8281919,1.118059065e-12,1431604,152124,92788936
70500,2050170666,8297699,1.120189365e-12,1415340,152076,92941012
70550,2053273042,8282109,1.118084715e-12,1437774,152568,93093580
70600,2050438542,8281709,1.118030715e-12,1424776,152076,93245656
70650,2054503625,8280797,1.117907595e-12,1395146,152124,93397780
70700,2044489208,8280924,1.11792474e-12,1399269,152576,93550356
70750,2049253917,8295385,1.119876975e-12,1340128,150732,93701088
70800,2421428166,8280782,1.11790557e-12,1394641,152328,93853416
70850,2407303125,8280714,1.11789639e-12,1392447,152028,94005444
70900,2250626459,8280666,1.11788991e-12,1390894,152004,94157448
70950,2070977625,8297248,1.12012848e-12,1400674,152520,94309968
71000,2053866500,8280742,1.11790017e-12,1393354,152028,94461996
71050,2041844167,8282929,1.1181954150000001e-12,1464428,152612,94614608
71100,2038636916,8281813,1.1180447550000001e-12,1428145,151584,94766192
71150,2033661250,8281882,1.11805407e-12,1430404,152100,94918292
71200,2042704667,8298461,1.120292235e-12,1440098,152076,95070368
71250,2033806917,8282044,1.11807594e-12,1435668,151980,95222348
71300,2043564666,8282375,1.118120625e-12,1446418,152512,95374860
71350,2056080708,8281695,1.118028825e-12,1424322,152228,95527088
71400,2035812750,8281165,1.117957275e-12,1407106,151684,95678772
71450,2035844709,8298835,1.120342725e-12,1452225,152472,95831244
71500,2031674500,8281406,1.11798981e-12,1414918,151908,95983152
71550,2036007417,8281881,1.118053935e-12,1430360,152480,96135632
71600,2039851042,8282030,1.11807405e-12,1435206,152496,96288128
71650,2062072334,8282851,1.118184885e-12,1461885,153368,96441496
71700,2118827041,8297579,1.120173165e-12,1411417,151500,96592996
71750,2342732667,8282250,1.11810375e-12,1442380,152472,96745468
71800,2259806958,8281544,1.11800844e-12,1419423,151980,96897448
71850,2055326375,8281344,1.11798144e-12,1412919,152076,97049524
71900,2059740541,8298401,1.120284135e-12,1438138,152544,97202068
71950,2063923167,8281775,1.118039625e-12,1426920,151980,97354048
72000,2051347042,8281442,1.11799467e-12,1416119,152388,97506436
72050,2051454792,8281575,1.118012625e-12,1420417,151476,97657912
72100,2040363541,8280156,1.1178210599999999e-12,1374292,150764,97808676
72150,2066222833,8298730,1.12032855e-12,1448832,152280,97960956
72200,2036052042,8282117,1.118085795e-12,1438050,152100,98113056
72250,2045404875,8282501,1.118137635e-12,1450512,152368,98265424
72300,2048226083,8281484,1.11800034e-12,1417458,152004,98417428
72350,2042256708,8282094,1.11808269e-12,1437279,152544,98569972
72400,2043741875,8298401,1.120284135e-12,1438132,152416,98722388
72450,2034526583,8281028,1.11793878e-12,1402658,151344,98873732
72500,2033119958,8282343,1.118116305e-12,1445396,152176,99025908
72550,2040973208,8282212,1.11809862e-12,1441118,152076,99177984
72600,2066304833,8281970,1.11806595e-12,1433252,152124,99330108
72650,2313565042,8298159,1.120251465e-12,1430252,152076,99482184
72700,2449962375,8281662,1.11802437e-12,1423260,151956,99634140
72750,2035667458,8281938,1.11806163e-12,1432210,152004,99786144
72800,2035684792,8281878,1.1180535300000001e-12,1430273,152132,99938276
72850,2037397917,8297094,1.12010769e-12,1395656,150852,100089128
72900,2042388208,8282327,1.118114145e-12,1444872,152124,100241252
72950,2036779125,8282086,1.11808161e-12,1437050,151932,100393184
73000,2038226875,8282082,1.11808107e-12,1436904,152028,100545212
73050,2033206750,8282531,1.118141685e-12,1451484,152116,100697328
73100,2036750708,8299035,1.120369725e-12,1458740,152512,100849840
73150,2038711292,8281494,1.1180016900000002e-12,1417804,152028,101001868
73200,2034839917,8281883,1.118054205e-12,1430425,152228,101154096
73250,2033090417,8282529,1.118141415e-12,1451414,152616,101306712
73300,2036059958,8281093,1.117947555e-12,1404752,151260,101457972
73350,2038527917,8298820,1.1203407e-12,1451749,152448,101610420
73400,2036458000,8281932,1.11806082e-12,1432019,152440,101762860
73450,2038879084,8282180,1.1180943e-12,1440078,152076,101914936
73500,2094613042,8283301,1.118245635e-12,1476507,153272,102068208
73550,2238102375,8297878,1.12021353e-12,1421124,151644,102219852
73600,2327557166,8281126,1.1179520100000001e-12,1405816,151500,102371352
73650,2306271458,8281832,1.11804732e-12,1428774,152028,102523380
73700,2044730917,8282082,1.11808107e-12,1436906,152076,102675456
73750,2032200625,8281474,1.11799899e-12,1417158,151980,102827436
73800,2032688666,8298420,1.1202867e-12,1438762,151956,102979392
73850,2044866917,8281825,1.118046375e-12,1428550,152100,103131492
73900,2051374333,8281631,1.1180201850000001e-12,1422246,152076,103283568
73950,2034437625,8281277,1.1179723949999999e-12,1410741,152156,103435724
74000,2050023166,8280371,1.117850085e-12,1381286,150972,103586696
74050,2039540375,8298772,1.1203342200000001e-12,1450202,152028,103738724
74100,2060209666,8281720,1.1180322e-12,1425136,152488,103891212
74150,2038045584,8281872,1.11805272e-12,1430076,152124,104043336
74200,2035228875,8282158,1.11809133e-12,1439372,152544,104195880
74250,2053361084,8298441,1.120289535e-12,1439444,152592,104348472
74300,2055915417,8280847,1.117914345e-12,1396751,151868,104500340
74350,2173537792,8281461,1.117997235e-12,1416712,151764,104652104
74400,2113569167,8281866,1.11805191e-12,1429894,152124,104804228
74450,2138731542,8282510,1.11813885e-12,1450800,152592,104956820
74500,2376963042,8298518,1.12029993e-12,1441925,152472,105109292
74550,2258112583,8281826,1.1180465100000002e-12,1428590,152124,105261416
74600,2038091167,8281256,1.1179695600000002e-12,1410050,152004,105413420
74650,2045138792,8281898,1.11805623e-12,1430928,152912,105566332
74700,2044943500,8279837,1.117777995e-12,1363948,150732,105717064
74750,2055953500,8298097,1.120243095e-12,1428246,152304,105869368
74800,2043713541,8282356,1.11811806e-12,1445816,152640,106022008
74850,2034826500,8281458,1.1179968300000001e-12,1416634,151972,106173980
74900,2050201375,8281886,1.11805461e-12,1430524,152028,106326008
74950,2034393291,8297628,1.1201797799999999e-12,1413002,152004,106478012
75000,2056242375,8281905,1.118057175e-12,1431137,152652,106630664
75050,2037023542,8280824,1.11791124e-12,1396008,150852,106781516
75100,2029501625,8282185,1.118094975e-12,1440255,152496,106934012
75150,2044466958,8282390,1.11812265e-12,1446902,152004,107086016
75200,2032368875,8297869,1.120212315e-12,1420834,151948,107237964
75250,2096437084,8281958,1.1180643299999999e-12,1432869,152600,107390564
75300,2110350542,8280843,1.117913805e-12,1396636,151500,107542064
75350,2455684333,8281866,1.11805191e-12,1429874,152052,107694116
75400,2287187958,8281878,1.1180535300000001e-12,1430272,152536,107846652
75450,2064859500,8297980,1.1202273e-12,1424458,152052,107998704
75500,2034247500,8281847,1.118049345e-12,1429280,151932,108150636
75550,2044038375,8282384,1.11812184e-12,1446723,152004,108302640
75600,2048354875,8281794,1.11804219e-12,1427529,152372,108455012
75650,2049818708,8297757,1.120197195e-12,1417212,151992,108607004
75700,2038036875,8280973,1.117931355e-12,1400850,151956,108758960
75750,2031913500,8281768,1.11803868e-12,1426684,152124,108911084
75800,2054242750,8281466,1.11799791e-12,1416888,152076,109063160
75850,2033164875,8281899,1.118056365e-12,1430950,152520,109215680
75900,2049639167,8298420,1.1202867e-12,1438742,152616,109368296
75950,2033642292,8282302,1.11811077e-12,1444034,153292,109521588
76000,2042764542,8278171,1.1175530849999999e-12,1309796,149892,109671480
76050,2044613709,8279837,1.117777995e-12,1363936,151272,109822752
76100,2044749208,8279895,1.117785825e-12,1365834,151248,109974000
76150,2038991833,8295665,1.1199147750000002e-12,1349223,150756,110124756
76200,2089475583,8279214,1.11769389e-12,1343678,150828,110275584
76250,2119749500,8279582,1.11774357e-12,1355655,150924,110426508
76300,2417142417,8279990,1.11779865e-12,1368922,151020,110577528
76350,2052601000,8297203,1.120122405e-12,1399191,152144,110729672
76400,2035812958,8280384,1.11785184e-12,1381704,151348,110881020
76450,2033019542,8281666,1.11802491e-12,1423366,152076,111033096
76500,2044982458,8281773,1.118039355e-12,1426850,152448,111185544
76550,2037509292,8281686,1.1180276100000001e-12,1424047,152076,111337620
76600,2038053375,8296787,1.1200662450000001e-12,1385688,150916,111488536
76650,2034962833,8281685,1.118027475e-12,1423982,151692,111640228
76700,2034126584,8282997,1.118204595e-12,1466640,152544,111792772
76750,2052164500,8282367,1.118119545e-12,1446178,152068,111944840
76800,2038293750,8282452,1.11813102e-12,1448922,152472,112097312
76850,2040880542,8298404,1.12028454e-12,1438250,152052,112249364
76900,2031056791,8282694,1.11816369e-12,1456771,152912,112402276
76950,2036706125,8278366,1.11757941e-12,1316142,149676,112551952
77000,2043404000,8280391,1.117852785e-12,1381943,151128,112703080
77050,2041609416,8281219,1.1179645650000001e-12,1408851,151320,112854400
77100,2058772250,8297399,1.1201488649999999e-12,1405581,151272,113005672
77150,2469078958,8280378,1.11785103e-12,1381504,151392,113157064
77200,2208423875,8279886,1.11778461e-12,1365528,150900,113307964
77250,2242340250,8279106,1.11767931e-12,1340185,150644,113458608
77300,2036593417,8294871,1.119807585e-12,1323429,149860,113608468
77350,2038212625,8278178,1.11755403e-12,1310029,149820,113758288
77400,2046658333,8279867,1.117782045e-12,1364922,150876,113909164
77450,2040491917,8280759,1.117902465e-12,1393894,151392,114060556
77500,2032507166,8280625,1.117884375e-12,1389548,151320,114211876
77550,2036348584,8296785,1.120065975e-12,1385626,150876,114362752
77600,2034487417,8280090,1.11781215e-12,1372161,151544,114514296
77650,2032248917,8278557,1.117605195e-12,1322350,150244,114664540
77700,2035780000,8279543,1.1177383050000001e-12,1354396,150900,114815440
77750,2032486792,8280055,1.117807425e-12,1371034,151248,114966688
77800,2039306459,8296291,1.1199992850000001e-12,1369545,150852,115117540
77850,2040539708,8279515,1.117734525e-12,1353486,150948,115268488
77900,2043956791,8279962,1.11779487e-12,1367993,151368,115419856
77950,2054770125,8279702,1.1177597700000001e-12,1359555,151292,115571148
78000,2097383000,8278297,1.117570095e-12,1313879,149964,115721112
78050,2137386708,8297232,1.12012632e-12,1400136,151152,115872264
78100,2324513041,8279120,1.1176812e-12,1340638,150588,116022852
78150,2035926459,8279842,1.1177786700000001e-12,1364104,150852,116173704
78200,2049063250,8280488,1.11786588e-12,1385098,151392,116325096
78250,2038664000,8296422,1.12001697e-12,1373802,151464,116476560
78300,2033970833,8280372,1.11785022e-12,1381311,151580,116628140
78350,2032759416,8281092,1.11794742e-12,1404726,151692,116779832
78400,2034485917,8279810,1.11777435e-12,1363064,151092,116930924
78450,2043199416,8280559,1.117875465e-12,1387412,151212,117082136
78500,2036545417,8298076,1.12024026e-12,1427584,152148,117234284
78550,2042523125,8281890,1.11805515e-12,1430646,152012,117386296
78600,2042776291,8281625,1.118019375e-12,1422050,152196,117538492
78650,2039508583,8281879,1.118053665e-12,1430296,152544,117691036
78700,2032497000,8281587,1.118014245e-12,1420826,152516,117843552
78750,2033502750,8296847,1.120074345e-12,1387646,151332,117994884
78800,2032361250,8281683,1.118027205e-12,1423934,152296,118147180
78850,14760557167,28237103,3.8120089050000004e-12,1436968,-24340288,93806892
78900,2038327500,8281493,1.118001555e-12,1417760,152164,93959056
78950,2035036041,8300955,1.120628925e-12,1415713,152076,94111132
79000,2042347333,8281574,1.11801249e-12,1420406,152028,94263160
79050,2035046334,8281672,1.11802572e-12,1423588,152052,94415212
79100,2035926750,8281440,1.1179944e-12,1416048,152424,94567636
79150,2034160084,8280946,1.11792771e-12,1399994,151476,94719112
79200,2032817375,8282144,1.11808944e-12,1438928,152520,94871632
79250,2039142292,8281534,1.11800709e-12,1419108,152044,95023676
79300,2040834417,8281542,1.1180081700000001e-12,1419368,152464,95176140
79350,2035436000,8281607,1.118016945e-12,1421462,152076,95328216
79400,2037801042,8281238,1.1179671300000001e-12,1409456,151956,95480172
79450,2033043000,8280680,1.1178918e-12,1391337,151860,95632032
79500,2035732000,8281057,1.1179426949999999e-12,1403586,151668,95783700
79550,2043398083,8281913,1.118058255e-12,1431398,151860,95935560
79600,2161139459,8281957,1.118064195e-12,1432824,152376,96087936
79650,2133760125,8300331,1.120544685e-12,1395425,152076,96240012
79700,2760116709,8281257,1.1179696950000001e-12,1410089,152028,96392040
79750,2328394167,8281115,1.117950525e-12,1405482,152020,96544060
79800,2244578500,8281791,1.118041785e-12,1427452,152172,96696232
79850,2034723208,8302172,1.1207932200000001e-12,1455274,153200,96849432
79900,2042196041,8281131,1.117952685e-12,1406010,151956,97001388
79950,2033701042,8281542,1.1180081700000001e-12,1419370,152100,97153488
80000,2046712417,8281522,1.1180054700000002e-12,1418699,152052,97305540
80050,2041375708,8281454,1.11799629e-12,1416480,152020,97457560
80100,2035485916,8300937,1.120626495e-12,1415138,151896,97609456
80150,2036170167,8281579,1.118013165e-12,1420558,151668,97761124
80200,2034805250,8282617,1.118153295e-12,1454298,152196,97913320
80250,2039745375,8282143,1.118089305e-12,1438890,151908,98065228
80300,2036802875,8281309,1.117976715e-12,1411768,152100,98217328
80350,2042397334,8301660,1.1207241e-12,1438636,152124,98369452
80400,2042404583,8281920,1.1180592e-12,1431636,152100,98521552
80450,2041991625,8281305,1.1179761749999999e-12,1411647,151988,98673540
80500,2057996583,8280435,1.1178587250000001e-12,1383362,151212,98824752
80550,2095444791,8280787,1.117906245e-12,1394828,151236,98975988
80600,2226467166,8302202,1.12079727e-12,1456226,152616,99128604
80650,2409218000,8282054,1.11807729e-12,1435994,152488,99281092
80700,2052051584,8281952,1.11806352e-12,1432661,152116,99433208
80750,2036305375,8281831,1.118047185e-12,1428740,152124,99585332
80800,2038148042,8301264,1.12067064e-12,1425769,152696,99738028
80850,2038123583,8281500,1.1180025e-12,1417976,152016,99890044
80900,2041113666,8282216,1.11809916e-12,1441250,152616,100042660
80950,2037226666,8282003,1.118070405e-12,1434338,152592,100195252
81000,2036314583,8282055,1.1180774250000001e-12,1436020,152568,100347820
81050,2050469458,8301287,1.120673745e-12,1426502,152100,100499920
81100,2036741958,8281301,1.117975635e-12,1411513,152228,100652148
81150,2049131709,8281715,1.1180315250000001e-12,1424962,152328,100804476
81200,2035561792,8280478,1.1178645299999999e-12,1384772,151404,100955880
81250,2033327791,8281492,1.11800142e-12,1417718,151932,101107812
81300,2035015375,8301635,1.120720725e-12,1437825,152520,101260332
81350,2039196375,8281954,1.11806379e-12,1432726,152124,101412456
81400,2047993459,8281626,1.11801951e-12,1422096,152196,101564652
81450,2196720792,8282645,1.118157075e-12,1455195,153344,101717996
81500,2293171833,8281791,1.118041785e-12,1427444,152352,101870348
81550,2219079541,8300417,1.120556295e-12,1398234,151252,102021600
81600,2048698750,8281614,1.11801789e-12,1421702,152052,102173652
81650,2041626000,8281444,1.11799494e-12,1416178,152100,102325752
81700,2046872625,8281383,1.1179867050000001e-12,1414200,152116,102477868
81750,2034950708,8301347,1.120681845e-12,1428466,152520,102630388
81800,2035178875,8280918,1.11792393e-12,1399074,152100,102782488
81850,2053129459,8280940,1.1179269e-12,1399785,152432,102934920
81900,2042267708,8279576,1.1177427599999999e-12,1355453,150900,103085820
81950,2051306459,8281462,1.11799737e-12,1416748,152100,103237920
82000,2039963000,8301163,1.1206570050000001e-12,1422476,152148,103390068
82050,2043297041,8281803,1.118043405e-12,1427830,151980,103542048
82100,2032546791,8282006,1.11807081e-12,1434450,152076,103694124
82150,2036376792,8281206,1.1179628100000001e-12,1408430,152004,103846128
82200,2047635584,8281417,1.117991295e-12,1415282,152052,103998180
82250,2042216250,8300371,1.120550085e-12,1396717,151812,104149992
82300,2060355250,8281447,1.117995345e-12,1416262,151932,104301924
82350,2152721209,8281861,1.118051235e-12,1429705,152392,104454316
82400,2495987084,8281732,1.11803382e-12,1425540,152004,104606320
82450,2286782708,8282279,1.118107665e-12,1443304,152592,104758912
82500,2047148417,8301455,1.120696425e-12,1431970,152076,104910988
82550,2044290500,8282195,1.118096325e-12,1440568,152124,105063112
82600,2018120416,8281526,1.11800601e-12,1418846,153016,105216128
82650,2033708917,8277884,1.11751434e-12,1300472,150132,105366260
82700,2035326292,8298611,1.120312485e-12,1339537,150516,105516776
82750,2038888500,8279538,1.1177376300000001e-12,1354221,150852,105667628
82800,2037908708,8280156,1.1178210599999999e-12,1374314,151368,105818996
82850,2045778000,8279666,1.11775491e-12,1358394,151020,105970016
82900,2041803750,8279815,1.117775025e-12,1363238,150972,106120988
82950,2037311750,8300006,1.12050081e-12,1384863,151952,106272940
83000,2031129000,8278402,1.11758427e-12,1317286,150012,106422952
83050,2036259625,8279814,1.1177748900000001e-12,1363172,150576,106573528
83100,2042784083,8279629,1.117749915e-12,1357186,150660,106724188
83150,2054807291,8279684,1.11775734e-12,1358954,151320,106875508
83200,2050493083,8298946,1.12035771e-12,1350420,150852,107026360
83250,2206289833,8279908,1.1177875799999999e-12,1366234,150924,107177284
83300,2295758708,8281289,1.117974015e-12,1411113,152504,107329788
83350,2246011458,8279424,1.11772224e-12,1350504,150492,107480280
83400,2244015250,8299557,1.1204401949999999e-12,1370278,151344,107631624
83450,2033843833,8279794,1.1177721900000002e-12,1362538,150972,107782596
83500,2032801042,8279953,1.117793655e-12,1367708,151320,107933916
83550,2033699541,8279598,1.11774573e-12,1356176,150244,108084160
83600,2049723166,8280541,1.117873035e-12,1386811,151236,108235396
83650,2038154959,8300671,1.120590585e-12,1406464,152052,108387448
83700,2031998375,8281722,1.11803247e-12,1425189,152424,108539872
83750,2050688167,8281582,1.11801357e-12,1420658,152076,108691948
83800,2037027833,8281742,1.1180351700000002e-12,1425864,152592,108844540
83850,2035979041,8281815,1.118045025e-12,1428218,152544,108997084
83900,2046418792,8299553,1.120439655e-12,1370134,151340,109148424
83950,2033875916,8278780,1.1176353e-12,1329584,149844,109298268
84000,2032207333,8278782,1.11763557e-12,1329662,150408,109448676
84050,2031564458,8279901,1.117786635e-12,1366002,150276,109598952
84100,2184545584,8280717,1.117896795e-12,1392528,151164,109750116
84150,2020955750,8300576,1.12057776e-12,1403400,151560,109901676
84200,2274515125,8282381,1.118121435e-12,1446602,152004,110053680
84250,2322793083,8282520,1.1181402e-12,1451122,152488,110206168
84300,2040226000,8282275,1.1181071250000001e-12,1443190,151980,110358148
84350,2049897250,8301658,1.1207238300000001e-12,1438564,152052,110510200
84400,2033835791,8281938,1.11806163e-12,1432207,152396,110662596
84450,2032144292,8280774,1.11790449e-12,1394380,151528,110814124
84500,2034131625,8281383,1.1179867050000001e-12,1414190,151180,110965304
84550,2037005834,8281927,1.118060145e-12,1431864,151980,111117284
84600,2034220833,8300875,1.120618125e-12,1413108,152028,111269312
84650,2049162167,8281902,1.1180567699999999e-12,1431054,152520,111421832
84700,2037023459,8282277,1.118107395e-12,1443226,152544,111574376
84750,2034518375,8281996,1.11806946e-12,1434117,152720,111727096
84800,2037072250,8281461,1.117997235e-12,1416726,152088,111879184
84850,2059309416,8301663,1.120724505e-12,1438708,152212,112031396
84900,2049999625,8282056,1.1180775600000001e-12,1436052,152520,112183916
84950,2038429500,8281772,1.11803922e-12,1426821,152100,112336016
85000,2046091667,8282051,1.118076885e-12,1435893,152448,112488464
85050,2126053000,8282997,1.118204595e-12,1466638,153440,112641904
85100,2123960500,8299935,1.120491225e-12,1382572,151360,112793264
85150,2146867750,8281297,1.117975095e-12,1411386,151836,112945100
85200,2393736166,8282010,1.11807135e-12,1434578,152496,113097596
85250,2043568625,8282379,1.118121165e-12,1446550,152608,113250204
85300,2049637542,8301900,1.1207565e-12,1446440,152592,113402796
85350,2041405542,8281424,1.11799224e-12,1415524,151956,113554752
85400,2032447000,8281346,1.1179817100000001e-12,1412991,152528,113707280
85450,2046507834,8280902,1.11792177e-12,1398554,151572,113858852
85500,2032724958,8281648,1.11802248e-12,1422792,151980,114010832
85550,2047891542,8302190,1.1207956500000001e-12,1455856,152512,114163344
85600,2048075625,8281933,1.118060955e-12,1432064,151980,114315324
85650,2034836584,8281141,1.117954035e-12,1406323,152100,114467424
85700,2035254916,8280905,1.117922175e-12,1398650,152568,114619992
85750,2033561500,8280724,1.11789774e-12,1392765,152036,114772028
85800,2041181333,8300727,1.120598145e-12,1408298,152004,114924032
85850,2037613125,8281638,1.11802113e-12,1422484,152616,115076648
85900,2164652167,8281474,1.11799899e-12,1417122,152004,115228652
85950,2119160666,8281147,1.117954845e-12,1406527,152172,115380824
86000,2317056958,8281014,1.1179368900000001e-12,1402198,152100,115532924
86050,2062486208,8301734,1.12073409e-12,1441020,152376,115685300
86100,2108022333,8282641,1.118156535e-12,1455071,153336,115838636
86150,2065478084,8280937,1.117926495e-12,1399674,151476,115990112
86200,2035647959,8281517,1.118004795e-12,1418532,152004,116142116
86250,2031829000,8301380,1.1206863e-12,1429520,151980,116294096
86300,2037305167,8281684,1.11802734e-12,1423971,152076,116446172
86350,2054613875,8281931,1.118060685e-12,1431996,152076,116598248
86400,2052501250,8281940,1.1180619e-12,1432295,152124,116750372
86450,2035120583,8281430,1.1179930500000001e-12,1415694,151956,116902328
86500,2056026500,8302227,1.120800645e-12,1457055,153044,117055372
86550,2037638625,8281877,1.118053395e-12,1430242,151944,117207316
86600,2055475375,8280566,1.1178764100000001e-12,1387628,151116,117358432
86650,2039964375,8282166,1.11809241e-12,1439618,152544,117510976
86700,2038204625,8281956,1.11806406e-12,1432800,152052,117663028
86750,2039277083,8301187,1.120660245e-12,1423232,152196,117815224
86800,2046118292,8282152,1.11809052e-12,1439180,152536,117967760
86850,2238004583,8281403,1.117989405e-12,1414848,152076,118119836
86900,2231112042,8282124,1.11808674e-12,1438279,152952,118272788
86950,2425497875,8299828,1.12047678e-12,1379086,151092,118423880
87000,2047774333,8280678,1.1178915300000001e-12,1391282,151212,118575092
87050,2036171833,8281091,1.117947285e-12,1404690,151560,118726652
87100,2051550458,8282423,1.118127105e-12,1447996,152040,118878692
87150,2051132417,8301303,1.120675905e-12,1427005,151900,119030592
87200,2052111875,8282847,1.118184345e-12,1461768,152448,119183040
87250,2043539500,8282278,1.11810753e-12,1443252,152544,119335584
87300,2033909666,8281823,1.118046105e-12,1428474,151932,119487516
87350,2036548792,8281830,1.11804705e-12,1428716,152100,119639616
87400,2037353458,8301011,1.120636485e-12,1417520,151940,119791556
87450,2035095541,8282065,1.1180787750000001e-12,1436353,152040,119943596
87500,2046848125,8281447,1.117995345e-12,1416269,151596,120095192
87550,2034560792,8282044,1.11807594e-12,1435670,152004,120247196
87600,2038901333,8282669,1.118160315e-12,1455962,152632,120399828
87650,2039941417,8301334,1.12068009e-12,1428034,151932,120551760
87700,2078051208,8282339,1.118115765e-12,1445262,152044,120703804
87750,2141995625,8282305,1.118111175e-12,1444149,152528,120856332
87800,2249013791,8281391,1.117987785e-12,1414452,151752,121008084
87850,2176961250,8282013,1.118071755e-12,1434668,152004,121160088
87900,2184991000,8301203,1.120662405e-12,1423764,152052,121312140
87950,2040251167,8281951,1.118063385e-12,1432636,151980,121464120
88000,2033671083,8281908,1.11805758e-12,1431240,152076,121616196
88050,2032240167,8282773,1.118174355e-12,1459348,152536,121768732
88100,2038419583,8282221,1.118099835e-12,1441413,152696,121921428
88150,2047624875,8302074,1.12077999e-12,1452088,152100,122073528
88200,2047294958,8282084,1.1180813400000001e-12,1436952,152040,122225568
88250,2033090708,8281835,1.1180477250000002e-12,1428886,152004,122377572
88300,2054661625,8281780,1.1180403000000001e-12,1427092,152052,122529624
88350,2033017041,8301578,1.12071303e-12,1435962,152568,122682192
88400,2034943625,8282451,1.118130885e-12,1448896,152632,122834824
88450,2045116000,8281685,1.118027475e-12,1423989,152276,122987100
88500,2043198125,8281829,1.118046915e-12,1428686,152100,123139200
88550,2047618375,8281496,1.11800196e-12,1417842,151896,123291096
88600,2042027250,8301357,1.120683195e-12,1428768,152536,123443632
88650,2134930417,8281542,1.1180081700000001e-12,1419344,152028,123595660
88700,2245958209,8281930,1.1180605499999999e-12,1431969,152124,123747784
88750,2307201209,8281669,1.118025315e-12,1423488,151956,123899740
88800,2227601250,8301609,1.120717215e-12,1436971,152612,124052352
88850,2034942125,8280958,1.11792933e-12,1400382,151488,124203840
88900,2038642041,8281567,1.118011545e-12,1420152,151980,124355820
88950,2036855541,8281912,1.11805812e-12,1431378,152424,124508244
89000,2031960625,8281721,1.118032335e-12,1425164,152148,124660392
89050,2035497916,8301799,1.1207428649999999e-12,1443142,152616,124813008
89100,2055290667,8281666,1.11802491e-12,1423364,152488,124965496
89150,2044226416,8281754,1.11803679e-12,1426242,152368,125117864
89200,2041019875,8279949,1.1177931150000001e-12,1367572,150924,125268788
89250,2033595834,8279603,1.117746405e-12,1356338,150876,125419664
89300,2035288458,8299768,1.12046868e-12,1377130,150900,125570564
89350,2031669208,8279895,1.117785825e-12,1365826,150804,125721368
89400,2032288667,8279900,1.1177865e-12,1365978,150852,125872220
89450,2031959708,8280378,1.11785103e-12,1381504,151416,126023636
89500,2109879708,8279637,1.117750995e-12,1357443,151172,126174808
89550,2328459791,8298284,1.12026834e-12,1328908,149988,126324796
89600,2279365250,8279163,1.117687005e-12,1342036,150444,126475240
89650,2349725250,8280328,1.11784428e-12,1379888,151248,126626488
89700,1969796542,8279895,1.117785825e-12,1365816,150852,126777340
89750,2035138000,8300137,1.120518495e-12,1389134,151344,126928684
89800,2037663958,8280445,1.117860075e-12,1383694,151224,127079908
89850,2037521417,8281929,1.118060415e-12,1431939,152648,127232556
89900,2045663291,8281663,1.118024505e-12,1423276,151732,127384288
89950,2040067667,8281428,1.11799278e-12,1415632,152004,127536292
90000,2040440625,8300829,1.120611915e-12,1411630,152068,127688360
90050,2048286250,8281495,1.1180018250000001e-12,1417820,152028,127840388
90100,2031158875,8280718,1.11789693e-12,1392552,150996,127991384
90150,2052805083,8281142,1.11795417e-12,1406360,151284,128142668
90200,2034229750,8281849,1.118049615e-12,1429334,152052,128294720
90250,2030748791,8301469,1.120698315e-12,1432402,152068,128446788
90300,2033126583,8282370,1.11811995e-12,1446266,152424,128599212
90350,2034350417,8281642,1.11802167e-12,1422594,152004,128751216
90400,2053734000,8281521,1.118005335e-12,1418680,152004,128903220
90450,2021866167,8281406,1.11798981e-12,1414933,152192,129055412
90500,2092647125,8300658,1.12058883e-12,1406062,151308,129206720
90550,2387248166,8282427,1.118127645e-12,1448130,152160,129358880
90600,2010535875,8281269,1.117971315e-12,1410480,152092,129510972
90650,2034496875,8281430,1.1179930500000001e-12,1415718,152124,129663096
90700,2046881750,8301516,1.12070466e-12,1433938,152124,129815220
90750,2054735958,8281447,1.117995345e-12,1416256,152124,129967344
90800,2050404041,8281358,1.11798333e-12,1413375,152252,130119596
90850,2048918417,8281094,1.1179476899999999e-12,1404786,151776,130271372
90900,2042316000,8281537,1.118007495e-12,1419181,152052,130423424
90950,2033569417,8301643,1.120721805e-12,1438084,152100,130575524
91000,2050743834,8281894,1.11805569e-12,1430806,152124,130727648
91050,2037448709,8282165,1.118092275e-12,1439610,152020,130879668
91100,2053299208,8282692,1.11816342e-12,1456736,152664,131032332
91150,2034086500,8281858,1.11805083e-12,1429610,151932,131184264
91200,2032498709,8301327,1.120679145e-12,1427801,152372,131336636
91250,2031894792,8281422,1.11799197e-12,1415470,151620,131488256
91300,2032627333,8281511,1.118003985e-12,1418358,151680,131639936
91350,2053980083,8282509,1.118138715e-12,1450762,152520,131792456
91400,2315773000,8301285,1.1206734749999999e-12,1426446,151884,131944340
91450,2186636166,8282128,1.11808728e-12,1438388,152100,132096440
91500,2164476125,8281907,1.118057445e-12,1431228,152028,132248468
91550,2025198500,8282163,1.1180920050000001e-12,1439535,152612,132401080
91600,2032074041,8279846,1.11777921e-12,1364224,150780,132551860
91650,2031648708,8300904,1.12062204e-12,1414067,151860,132703720
91700,2031767792,8281942,1.11806217e-12,1432344,152076,132855796
91750,2039912708,8281661,1.118024235e-12,1423206,152076,133007872
91800,2050048083,8281818,1.11804543e-12,1428340,152052,133159924
91850,2047451958,8281401,1.117989135e-12,1414772,152004,133311928
91900,2044802708,8301467,1.1206980450000001e-12,1432364,152124,133464052
91950,2051473917,8282756,1.11817206e-12,1458795,153368,133617420
92000,2031031459,8280756,1.11790206e-12,1393814,151560,133768980
92050,2037454167,8282332,1.11811482e-12,1445038,152172,133921152
92100,2021759000,8281964,1.11806514e-12,1433072,152076,134073228
92150,2038376250,8300631,1.1205851850000001e-12,1405162,152472,134225700
92200,2038595958,8281040,1.1179404e-12,1403026,152100,134377800
92250,2142872833,8281387,1.117987245e-12,1414324,152544,134530344
92300,2102225750,8281403,1.117989405e-12,1414839,152420,134682764
92350,2498613541,8299451,1.120425885e-12,1366824,151404,134834168
92400,2218544458,8281067,1.117944045e-12,1403926,152400,134986568
92450,2119962916,8281180,1.1179593e-12,1407592,152100,135138668
92500,2033738375,8281215,1.117964025e-12,1408730,152352,135291020
92550,2042247833,8282631,1.118155185e-12,1454738,152004,135443024
92600,2054301083,8301027,1.120638645e-12,1418032,152448,135595472
92650,2060308833,8282820,1.1181807e-12,1460889,153204,135748676
92700,2051843042,8281666,1.11802491e-12,1423395,152136,135900812
92750,2051348416,8281785,1.118040975e-12,1427258,152124,136052936
92800,2037691542,8281729,1.118033415e-12,1425412,152560,136205496
92850,2048247334,8301220,1.1206646999999999e-12,1424338,152076,136357572
92900,2038271667,8282204,1.11809754e-12,1440870,152608,136510180
92950,2052737000,8282056,1.1180775600000001e-12,1436041,152560,136662740
93000,2036499041,8282954,1.11819879e-12,1465251,153392,136816132
93050,2031236709,8281670,1.11802545e-12,1423526,151836,136967968
93100,2040408458,8300411,1.120555485e-12,1398040,151068,137119036
93150,2043774000,8281813,1.1180447550000001e-12,1428158,152124,137271160
93200,2167411042,8281573,1.118012355e-12,1420344,152124,137423284
93250,2147003167,8281659,1.1180239650000001e-12,1423162,152496,137575780
93300,2264882417,8300696,1.12059396e-12,1407310,152028,137727808
93350,2303249625,8281426,1.11799251e-12,1415594,152076,137879884
93400,2384343542,8281397,1.117988595e-12,1414622,152124,138032008
93450,2047256292,8280498,1.11786723e-12,1385421,152060,138184068
93500,2030621292,8280348,1.11784698e-12,1380556,151560,138335628
93550,2035944792,8300300,1.1205405e-12,1394434,150852,138486480
93600,2038064709,8279599,1.1177458650000001e-12,1356198,150804,138637284
93650,2041670500,8280658,1.1178888300000002e-12,1390610,151740,138789024
93700,2038028375,8281118,1.11795093e-12,1405574,152400,138941424
93750,2035858083,8281005,1.1179356750000001e-12,1401906,151932,139093356
93800,2034851458,8300805,1.120608675e-12,1410836,151956,139245312
93850,2032424042,8281371,1.117985085e-12,1413804,152448,139397760
93900,2047622958,8280836,1.11791286e-12,1396397,152036,139549796
93950,2034907625,8279531,1.117736685e-12,1353988,151044,139700840
94000,2055868666,8300245,1.120533075e-12,1392630,152016,139852856
94050,2037554416,8283351,1.118252385e-12,1478132,152028,140004884
94100,2044166416,8282097,1.118083095e-12,1437384,152052,140156936
94150,2054657916,8281931,1.118060685e-12,1432002,152464,140309400
94200,2154183792,8282318,1.11811293e-12,1444588,152028,140461428
94250,2635803292,8300676,1.12059126e-12,1406635,152640,140614068
94300,2245057625,8281852,1.11805002e-12,1429434,151900,140765968
94350,2048448042,8281725,1.118032875e-12,1425296,152052,140918020
94400,2043137750,8282152,1.11809052e-12,1439184,152028,141070048
94450,2034878750,8301280,1.1206728000000001e-12,1426284,151980,141222028
94500,2039100084,8281474,1.11799899e-12,1417152,151996,141374024
94550,2037621750,8282097,1.118083095e-12,1437388,151980,141526004
94600,2034206041,8281828,1.11804678e-12,1428658,152196,141678200
94650,4705371084,32235599,4.351805865e-12,1428639,-29073896,112604304
94700,2039251583,8281624,1.11801924e-12,1422016,152088,112756392
94750,2038994708,8280468,1.11786318e-12,1384446,151140,112907532
94800,2021199625,8281739,1.118034765e-12,1425747,152028,113059560
94850,2045445167,8282420,1.1181267000000001e-12,1447896,152640,113212200
94900,2035521458,8305509,1.121243715e-12,1438522,152616,113364816
94950,2033269833,8282090,1.11808215e-12,1437144,152172,113516988
95000,2040939834,8282566,1.11814641e-12,1452620,152816,113669804
95050,2047686167,8280700,1.1178945e-12,1391982,150900,113820704
95100,2070082833,8283130,1.1182225500000001e-12,1470976,153180,113973884
95150,2400252958,8305288,1.12121388e-12,1431336,152076,114125960
95200,2062970000,8281853,1.118050155e-12,1429466,152472,114278432
95250,2043538125,8282194,1.11809619e-12,1440526,152212,114430644
95300,2037766542,8281886,1.11805461e-12,1430533,152624,114583268
95350,2032480000,8304636,1.12112586e-12,1410167,151800,114735068
95400,2034440292,8282132,1.11808782e-12,1438520,152076,114887144
95450,2038505250,8282494,1.11813669e-12,1450286,152496,115039640
95500,2040437209,8281615,1.118018025e-12,1421728,152100,115191740
95550,2048130458,8281764,1.11803814e-12,1426570,152100,115343840
95600,2037409833,8305188,1.1212003800000002e-12,1428096,152472,115496312
95650,2051391125,8281911,1.118057985e-12,1431352,152596,115648908
95700,2038440625,8280067,1.117809045e-12,1371414,150912,115799820
95750,2047743959,8279884,1.1177843400000001e-12,1365458,150820,115950640
95800,2032836125,8280227,1.117830645e-12,1376623,150756,116101396
95850,2037289250,8303211,1.120933485e-12,1363855,150876,116252272
95900,2038665875,8279438,1.11772413e-12,1350982,150756,116403028
95950,2038891791,8280311,1.117841985e-12,1379352,150900,116553928
96000,2134250208,8280507,1.117868445e-12,1385730,151212,116705140
96050,2157712167,8305002,1.1211752700000001e-12,1422035,152072,116857212
96100,2044544459,8279213,1.117693755e-12,1343646,150012,117007224
96150,2150132541,8280338,1.11784563e-12,1380219,151344,117158568
96200,2043162417,8279729,1.1177634150000001e-12,1360436,150900,117309468
96250,2032273000,8279606,1.11774681e-12,1356446,150852,117460320
96300,2040487583,8303286,1.12094361e-12,1366272,150820,117611140
96350,2031870167,8279968,1.1177956800000001e-12,1368206,150948,117762088
96400,2035345459,8280799,1.117907865e-12,1395196,152144,117914232
96450,2047169167,8279079,1.117675665e-12,1339308,150648,118064880
96500,2040944584,8278888,1.11764988e-12,1333110,150012,118214892
96550,2041587167,8302504,1.12083804e-12,1340852,150168,118365060
96600,2031781167,8278754,1.11763179e-12,1328724,150168,118515228
96650,2034575208,8279155,1.117685925e-12,1341786,150300,118665528
96700,2043896042,8280102,1.11781377e-12,1372546,150892,118816420
96750,2032645875,8280284,1.11783834e-12,1378474,151416,118967836
96800,2032599291,8302890,1.1208901500000002e-12,1353402,150900,119118736
96850,2085354750,8280003,1.117800405e-12,1369334,150804,119269540
96900,2075052292,8280045,1.117806075e-12,1370683,151388,119420928
96950,2574823291,8278736,1.11762936e-12,1328157,149652,119570580
97000,2534845000,8302171,1.120793085e-12,1330031,149676,119720256
97050,2220517667,8279690,1.11775815e-12,1359173,150636,119870892
97100,2047059083,8280923,1.117924605e-12,1399226,151416,120022308
97150,2033775000,8281113,1.1179502549999999e-12,1405419,151368,120173676
97200,2036991083,8303376,1.1209557600000002e-12,1369204,150780,120324456
97250,2050523917,8280044,1.11780594e-12,1370677,150852,120475308
97300,2047797667,8281562,1.1180108699999999e-12,1419985,152192,120627500
97350,2053063209,8281766,1.11803841e-12,1426640,151956,120779456
97400,2044615791,8281906,1.1180573100000001e-12,1431166,152052,120931508
97450,2038148959,8305221,1.121204835e-12,1429178,151948,121083456
97500,2033022458,8282674,1.11816099e-12,1456132,152568,121236024
97550,2043843209,8282857,1.118185695e-12,1462089,152688,121388712
97600,2036979667,8281527,1.118006145e-12,1418864,151980,121540692
97650,2041096417,8281767,1.118038545e-12,1426661,152552,121693244
97700,2027468291,8303754,1.1210067900000002e-12,1381486,150876,121844120
97750,2040869417,8281576,1.11801276e-12,1420462,151668,121995788
97800,2023035833,8282319,1.118113065e-12,1444618,152440,122148228
97850,2056158209,8282277,1.118107395e-12,1443236,152100,122300328
97900,2340803417,8282066,1.11807891e-12,1436386,152560,122452888
97950,2435386250,8281730,1.11803355e-12,1425454,151860,122604748
98000,2036212375,8281865,1.1180517749999999e-12,1429837,152276,122757024
98050,2033381459,8280279,1.117837665e-12,1378300,150900,122907924
98100,2033102917,8282990,1.1182036500000001e-12,1466418,152496,123060420
98150,2033428042,8305688,1.12126788e-12,1444340,152584,123213004
98200,2032113458,8281529,1.118006415e-12,1418930,152052,123365056
98250,2048179500,8281869,1.1180523150000001e-12,1429966,152148,123517204
98300,2047580208,8281514,1.1180043900000001e-12,1418436,152004,123669208
98350,2049730584,8282033,1.118074455e-12,1435315,152588,123821796
98400,2032774500,8304073,1.1210498550000001e-12,1391868,151308,123973104
98450,2035215875,8282239,1.118102265e-12,1442009,152052,124125156
98500,2039483833,8281759,1.118037465e-12,1426394,151980,124277136
98550,2049911292,8281726,1.11803301e-12,1425348,152052,124429188
98600,2040443542,8282218,1.11809943e-12,1441312,152616,124581804
98650,2031577000,8305178,1.12119903e-12,1427770,152148,124733952
98700,2080064083,8281571,1.1180120849999999e-12,1420286,152148,124886100
98750,2075490000,8281690,1.11802815e-12,1424151,152696,125038796
98800,2080555667,8280793,1.117907055e-12,1394992,151848,125190644
98850,2248370375,8305297,1.121215095e-12,1431626,152608,125343252
98900,2199849792,8281443,1.117994805e-12,1416125,152028,125495280
98950,2030956333,8281860,1.1180511e-12,1429686,152196,125647476
99000,2033300083,8281551,1.1180093850000001e-12,1419636,152520,125799996
99050,2042561417,8281086,1.11794661e-12,1404512,152004,125952000
99100,2042679875,8305308,1.12121658e-12,1431995,152468,126104468
99150,2048792375,8281071,1.117944585e-12,1404032,151728,126256196
99200,2050269208,8281669,1.118025315e-12,1423464,151704,126407900
99250,2047437084,8280628,1.11788478e-12,1389632,151428,126559328
99300,2039553167,8281003,1.117935405e-12,1401824,151816,126711144
99350,2032884333,8304035,1.121044725e-12,1390606,151332,126862476
99400,2044911417,8282690,1.1181631500000002e-12,1456657,153008,127015484
99450,2036842958,8281055,1.117942425e-12,1403526,151308,127166792
99500,2035754584,8281165,1.117957275e-12,1407084,151188,127317980
99550,2031130542,8281317,1.117977795e-12,1412026,151824,127469804
99600,2043842542,8303615,1.1209880250000001e-12,1376980,150996,127620800
99650,2053142917,8281950,1.11806325e-12,1432601,152208,127773008
99700,2128072541,8281974,1.11806649e-12,1433374,151980,127924988
99750,2390983791,8281998,1.11806973e-12,1434158,152376,128077364
99800,2367509000,8305408,1.1212300800000001e-12,1435236,152052,128229416
99850,2049964334,8282338,1.11811563e-12,1445232,152448,128381864
99900,2036369167,8281352,1.11798252e-12,1413189,152288,128534152
99950,2042526708,8281323,1.1179786049999999e-12,1412240,151548,128685700
100000,2033219583,8282689,1.118163015e-12,1456622,152496,128838196
100050,2045827000,8305043,1.121180805e-12,1423376,152124,128990320
100100,2050877083,8281421,1.117991835e-12,1415418,152592,129142912
100150,2047616542,8281514,1.1180043900000001e-12,1418436,152100,129295012
100200,2033995042,8281878,1.1180535300000001e-12,1430266,152124,129447136
100250,2050240542,8281764,1.11803814e-12,1426559,152528,129599664
100300,2016160500,8303349,1.1209521150000001e-12,1368334,150900,129750564
100350,2039898166,8280652,1.11788802e-12,1390412,151596,129902160
100400,2052505291,8282092,1.1180824200000002e-12,1437226,152520,130054680
100450,2038819042,8282222,1.11809997e-12,1441444,152520,130207200
100500,2058313750,8282115,1.118085525e-12,1437970,152592,130359792
100550,2238153292,8305924,1.12129974e-12,1452013,153296,130513088
100600,2590770333,8281704,1.11803004e-12,1424602,152076,130665164
100650,2146029250,8281459,1.117996965e-12,1416660,152496,130817660
100700,2187817625,8281484,1.11800034e-12,1417474,152520,130970180
100750,2039034916,8304526,1.1211110100000001e-12,1406578,152424,131122604
100800,2046720375,8281246,1.11796821e-12,1409714,152076,131274680
100850,2032663875,8281930,1.1180605499999999e-12,1431965,153416,131428096
100900,2031856541,8280696,1.1178939600000001e-12,1391852,151920,131580016
100950,2032325041,8281434,1.11799359e-12,1415824,152148,131732164
101000,2037128458,8305350,1.12122225e-12,1433360,152640,131884804
101050,2042265833,8281561,1.1180107349999999e-12,1419954,151956,132036760
101100,2037885667,8281170,1.11795795e-12,1407272,152568,132189328
101150,2032148708,8281064,1.11794364e-12,1403814,152148,132341476
101200,2025507042,8304822,1.12115097e-12,1416183,152864,132494340
101250,2031634375,8279669,1.117755315e-12,1358490,151260,132645600
101300,2044602625,8280366,1.11784941e-12,1381120,151644,132797244
101350,2055791875,8280954,1.11792879e-12,1400242,152028,132949272
101400,2041173167,8281149,1.117955115e-12,1406586,152124,133101396
101450,2048070208,8304386,1.1210921100000001e-12,1402028,152100,133253496
101500,2168856334,8281429,1.1179929150000002e-12,1415680,152440,133405936
101550,2238713708,8282693,1.118163555e-12,1456762,153312,133559248
101600,2467972666,8282798,1.1181777300000001e-12,1460157,153408,133712656
101650,2032967583,8283220,1.1182347e-12,1473886,153792,133866448
101700,2046641333,8306365,1.121359275e-12,1466344,153624,134020072
101750,2034454167,8283554,1.11827979e-12,1484733,153768,134173840
101800,2036352417,8283245,1.118238075e-12,1474682,153276,134327116
101850,2054966875,8285434,1.11853359e-12,1545846,155728,134482844
101900,2037590042,8280945,1.117927575e-12,1399946,152088,134634932
101950,2044090209,8281798,1.1180427300000002e-12,1427674,152496,134787428
102000,2037479583,8281228,1.1179657800000002e-12,1409146,152004,134939432
102050,2020982834,8281551,1.1180093850000001e-12,1419652,151980,135091412
102100,2038024416,8279242,1.11769767e-12,1344598,150084,135241496
102150,2073599709,8303705,1.121000175e-12,1379896,150828,135392324
102200,2035093250,8281033,1.1179394550000001e-12,1402816,150900,135543224
102250,2038573709,8280281,1.1178379350000001e-12,1378366,150732,135693956
102300,2034273959,8280387,1.117852245e-12,1381814,150828,135844784
102350,2041247833,8280203,1.117827405e-12,1375830,150804,135995588
102400,2167932208,8303670,1.12099545e-12,1378766,150852,136146440
102450,2219962000,8282440,1.1181294e-12,1448523,152760,136299200
102500,2441236334,8281829,1.118046915e-12,1428668,151644,136450844
102550,2053869166,8281575,1.118012625e-12,1420418,151332,136602176
102600,2033056875,8301610,1.12071735e-12,1311816,149580,136751756
102650,2039996834,8279589,1.117744515e-12,1355886,150444,136902200
102700,2032675875,8279845,1.117779075e-12,1364198,150708,137052908
102750,2049879667,8280842,1.11791367e-12,1396610,151392,137204300
102800,2048421375,8280016,1.11780216e-12,1369754,150948,137355248
102850,2043094250,8303420,1.1209617e-12,1370645,150804,137506052
102900,2033808750,8280421,1.117856835e-12,1382930,150900,137656952
102950,2050771625,8280043,1.1178058050000001e-12,1370640,151100,137808052
103000,2032119417,8279188,1.1176903800000001e-12,1342848,150288,137958340
103050,2034452375,8281631,1.1180201850000001e-12,1422251,151668,138110008
103100,2033199125,8303189,1.120930515e-12,1363132,150756,138260764
103150,2033620500,8280388,1.11785238e-12,1381846,151344,138412108
103200,2032009250,8279366,1.1177144099999999e-12,1348636,150756,138562864
103250,2034968084,8281188,1.11796038e-12,1407851,152192,138715056
103300,2101326334,8278255,1.117564425e-12,1312518,149652,138864708
103350,2456357541,8302739,1.120869765e-12,1348520,150688,139015396
103400,1985611500,8279650,1.11775275e-12,1357876,150828,139166224
103450,2226128875,8280151,1.117820385e-12,1374132,150900,139317124
103500,2047839750,8280282,1.11783807e-12,1378406,151200,139468324
103550,2042022042,8304235,1.121071725e-12,1397108,150852,139619176
103600,2034272584,8279850,1.11777975e-12,1364356,150804,139769980
103650,2036217583,8280171,1.117823085e-12,1374783,151292,139921272
103700,2034050584,8280638,1.11788613e-12,1389988,151344,140072616
103750,2032197375,8278570,1.11760695e-12,1322750,150028,140222644
103800,2041106541,8302924,1.1208947400000001e-12,1354506,150828,140373472
103850,2035568875,8279582,1.11774357e-12,1355640,150828,140524300
103900,2040205083,8279860,1.1177811e-12,1364696,150940,140675240
103950,2041188333,8279765,1.117768275e-12,1361610,150820,140826060
104000,2033940291,8280114,1.11781539e-12,1372924,150972,140977032
104050,2046700667,8304513,1.121109255e-12,1406164,151616,141128648
104100,2039845833,8279956,1.11779406e-12,1367816,150564,141279212
104150,2048210375,8279935,1.117791225e-12,1367136,150876,141430088
104200,2112917083,8280814,1.11790989e-12,1395690,151296,141581384
104250,2526849041,8280572,1.11787722e-12,1387834,150948,141732332
104300,2416082750,8304147,1.121059845e-12,1394276,151176,141883508
104350,2242872792,8279939,1.117791765e-12,1367262,150868,142034376
104400,2044075416,8279962,1.11779487e-12,1367997,151056,142185432
104450,2038758917,8280805,1.117908675e-12,1395408,151272,142336704
104500,2053953041,8304386,1.1210921100000001e-12,1402012,151392,142488096
104550,2034450667,8280707,1.1178954449999999e-12,1392222,151392,142639488
104600,2031813791,8280009,1.117801215e-12,1369535,150828,142790316
104650,2037050750,8280421,1.117856835e-12,1382904,151224,142941540
104700,2035676625,8279871,1.1177825849999999e-12,1365035,150884,143092424
104750,2042817875,8302505,1.120838175e-12,1340900,150012,143242436
104800,2036869750,8279727,1.117763145e-12,1360380,150604,143393040
104850,2036560750,8280294,1.11783969e-12,1378794,150876,143543916
104900,2038644375,8280425,1.117857375e-12,1383048,151320,143695236
104950,2032585875,8280098,1.1178132300000001e-12,1372430,150780,143846016
105000,2042614375,8303821,1.121015835e-12,1383665,151320,143997336
105050,2265795750,8280282,1.11783807e-12,1378405,151364,144148700
105100,2081906166,8278940,1.1176569000000001e-12,1334772,149908,144298608
105150,2492121291,8279986,1.1177981100000001e-12,1368770,150732,144449340
105200,2342291625,8304367,1.1210895450000001e-12,1401420,151272,144600612
105250,2041941542,8280237,1.117831995e-12,1376926,150876,144751488
105300,2046909459,8280749,1.117901115e-12,1393576,150852,144902340
105350,2034881167,8280422,1.1178569699999999e-12,1382962,150780,145053120
105400,2035796834,8280257,1.117834695e-12,1377575,150748,145203868
105450,2033290333,8303302,1.1209457700000001e-12,1366782,150568,145354436
105500,2036973958,8279554,1.11773979e-12,1354751,149868,145504304
105550,2047603083,8281005,1.1179356750000001e-12,1401908,150876,145655180
105600,2047165000,8279789,1.117771515e-12,1362386,150852,145806032
105650,2036168541,8303955,1.121033925e-12,1388030,151320,145957352
105700,2043803250,8280084,1.11781134e-12,1371978,150876,146108228
105750,2036150708,8279949,1.1177931150000001e-12,1367577,150804,146259032
105800,2044557666,8280418,1.11785643e-12,1382812,150900,146409932
105850,2033874458,8281309,1.117976715e-12,1411761,151692,146561624
105900,2034939458,8303921,1.121029335e-12,1386924,151140,146712764
105950,2084247000,8281933,1.118060955e-12,1432064,152064,146864828
106000,2145998333,8282458,1.11813183e-12,1449114,152616,147017444
106050,2400540250,8281305,1.1179761749999999e-12,1411655,151956,147169400
106100,2194427708,8282806,1.11817881e-12,1460447,152520,147321920
106150,2519333084,8306622,1.12139397e-12,1474702,153240,147475160
106200,2042617459,8280725,1.1178978749999999e-12,1392804,150876,147626036
106250,2039418334,8281871,1.118052585e-12,1430042,151764,147777800
106300,2043038250,8282059,1.118077965e-12,1436158,152004,147929804
106350,2036555000,8305291,1.121214285e-12,1431434,151924,148081728
106400,2025318833,8282883,1.118189205e-12,1462942,152440,148234168
106450,2042354250,8282363,1.118119005e-12,1446022,152568,148386736
106500,2037028375,8282178,1.1180940299999999e-12,1440037,151980,148538716
106550,2040275125,8281909,1.118057715e-12,1431280,152336,148691052
106600,2036343333,8305197,1.121201595e-12,1428380,151668,148842720
106650,2051796417,8281342,1.1179811699999999e-12,1412834,152064,148994784
106700,2035574667,8281432,1.11799332e-12,1415778,151932,149146716
106750,2045113958,8281397,1.117988595e-12,1414642,152076,149298792
106800,2045280958,8281761,1.1180377350000001e-12,1426454,152124,149450916
106850,2043197417,8305249,1.121208615e-12,1430080,152076,149602992
106900,2033014542,8282194,1.11809619e-12,1440528,152816,149755808
106950,2260872250,8281394,1.11798819e-12,1414530,152076,149907884
107000,2280075167,8281086,1.11794661e-12,1404520,151680,150059564
107050,2185202125,8282026,1.11807351e-12,1435098,151956,150211520
107100,2032503792,8304904,1.1211620400000001e-12,1418874,152520,150364040
107150,2046710125,8280942,1.11792717e-12,1399848,151908,150515948
107200,2036230458,8281073,1.117944855e-12,1404094,152004,150667952
107250,2035676291,8281155,1.117955925e-12,1406778,152528,150820480
107300,2032907084,8302673,1.120860855e-12,1346356,150756,150971236
107350,2038783834,8281032,1.11793932e-12,1402780,152184,151123420
107400,2041060375,8280782,1.11790557e-12,1394640,151836,151275256
107450,2044250084,8280996,1.11793446e-12,1401610,151956,151427212
107500,2024009292,8281580,1.1180132999999999e-12,1420590,152328,151579540
107550,2042973875,8305987,1.1213082450000002e-12,1454060,151956,151731496
107600,2034566375,8281860,1.1180511e-12,1429675,152756,151884252
107650,2034479959,8280363,1.117849005e-12,1381028,151212,152035464
107700,2045051208,8282134,1.11808809e-12,1438580,152568,152188032
107750,2037649625,8281822,1.11804597e-12,1428438,152100,152340132
107800,2064402375,8305252,1.12120902e-12,1430166,152100,152492232
107850,2291374458,8281834,1.11804759e-12,1428836,152148,152644380
107900,2272389000,8281771,1.1180390850000001e-12,1426784,152496,152796876
107950,2159481000,8281128,1.11795228e-12,1405902,152052,152948928
108000,2043485542,8281664,1.1180246399999999e-12,1423306,152432,153101360
108050,2039884708,8305439,1.121234265e-12,1436266,151932,153253292
108100,2037817875,8281771,1.1180390850000001e-12,1426807,152472,153405764
108150,2034518875,8281661,1.118024235e-12,1423205,152076,153557840
108200,2033083417,8281667,1.118025045e-12,1423414,152076,153709916
108250,2034668458,8281766,1.11803841e-12,1426648,152584,153862500
108300,2049568542,8304972,1.12117122e-12,1421085,151980,154014480
108350,2039569959,8281284,1.11797334e-12,1410957,152036,154166516
108400,2032360291,8280151,1.117820385e-12,1374134,150948,154317464
108450,2034230708,8281390,1.11798765e-12,1414416,152152,154469616
108500,2034055209,8281488,1.11800088e-12,1417590,152052,154621668
108550,2033986625,8305589,1.121254515e-12,1441118,152004,154773672
108600,2036198334,8280166,1.11782241e-12,1374624,150852,154924524
108650,2349891083,8282685,1.118162475e-12,1456506,151996,155076520
108700,2241897875,8282080,1.1180808e-12,1436850,151836,155228356
108750,2200103833,8305754,1.12127679e-12,1446500,152124,155380480
108800,2240495334,8282702,1.11816477e-12,1457070,152172,155532652
108850,2049895000,8282403,1.118124405e-12,1447344,152100,155684752
108900,2040918875,8282153,1.118090655e-12,1439212,151756,155836508
108950,2038328834,8305993,1.121309055e-12,1454244,153104,155989612
109000,2036734625,8282137,1.118088495e-12,1438690,151716,156141328
109050,2033694042,8281267,1.117971045e-12,1410412,151308,156292636
109100,2034833625,8280200,1.117827e-12,1375724,150924,156443560
109150,2037903834,8281657,1.118023695e-12,1423082,151764,156595324
109200,2051640834,8305394,1.12122819e-12,1434788,152376,156747700
109250,2038785917,8281912,1.11805812e-12,1431366,152100,156899800
109300,2044663542,8282095,1.118082825e-12,1437324,152100,157051900
109350,2038760625,8282417,1.118126295e-12,1447774,152520,157204420
109400,2035163500,8282942,1.11819717e-12,1464857,153464,157357884
109450,2031480625,8303209,1.1209332150000001e-12,1363776,150852,157508736
109500,2038953416,8281686,1.1180276100000001e-12,1424022,152232,157660968
109550,2039292458,8281387,1.117987245e-12,1414314,152004,157812972
109600,2391296292,8282077,1.118080395e-12,1436750,152376,157965348
109650,2394741708,8282050,1.11807675e-12,1435878,152632,158117980
109700,2255616084,8305278,1.1212125300000001e-12,1431013,152004,158269984
109750,2040095959,8281762,1.11803787e-12,1426503,152372,158422356
109800,2063089583,8279721,1.117762335e-12,1360163,150820,158573176
109850,2051953750,8280917,1.117923795e-12,1399034,151344,158724520
109900,2034596750,8305675,1.1212661250000001e-12,1443912,152520,158877040
109950,2039736500,8282020,1.1180727e-12,1434890,152076,159029116
110000,2037571625,8282090,1.11808215e-12,1437156,152004,159181120
110050,2040936042,8281829,1.118046915e-12,1428688,152052,159333172
110100,2043341000,8281833,1.118047455e-12,1428814,152124,159485296
110150,2033229208,8305164,1.12119714e-12,1427329,152744,159638040
110200,2052291708,8280481,1.117864935e-12,1384856,151092,159789132
110250,2035176250,8282235,1.118101725e-12,1441884,152544,159941676
110300,2042002208,8281749,1.118036115e-12,1426076,152052,160093728
110350,2047763958,8282057,1.118077695e-12,1436076,152124,160245852
110400,2039659709,8305414,1.12123089e-12,1435436,152076,160397928
110450,2178255875,8281730,1.11803355e-12,1425454,152568,160550496
110500,2113332167,8281476,1.1179992600000001e-12,1417208,152528,160703024
110550,2198148791,8280625,1.117884375e-12,1389551,151488,160854512
110600,2335130667,8305032,1.12117932e-12,1423022,152076,161006588
110650,2140741416,8281120,1.1179512e-12,1405636,152172,161158760
110700,2037693041,8281130,1.11795255e-12,1405968,152440,161311200
110750,2048174459,8281230,1.11796605e-12,1409208,152100,161463300
110800,2035767791,8282307,1.118111445e-12,1444203,153392,161616692
110850,2041622250,8303471,1.120968585e-12,1372282,151188,161767880
110900,2048131500,8280938,1.11792663e-12,1399711,151956,161919836
110950,2046824792,8281197,1.117961595e-12,1408132,152076,162071912
111000,2045199000,8281692,1.1180284199999999e-12,1424212,152472,162224384
111050,2040093375,8282196,1.11809646e-12,1440612,152052,162376436
111100,2036375458,8304995,1.121174325e-12,1421820,152472,162528908
111150,2040179583,8283589,1.118284515e-12,1485883,154260,162683168
