Size,Time,Cycles,Price,Instructions,HeapSize,TotalHeapSize
500,2054206541,80814068,1.0909899179999998e-11,6801247,574160,574804
1000,2055913291,80813434,1.090981359e-11,8160892,1221492,1796296
1500,2049926542,81153553,1.0955729655e-11,8615542,-67532,1728764
2000,2060459625,80840186,1.091342511e-11,9030308,1229440,2958204
2500,2074628709,81381916,1.098655866e-11,9013823,-76324,2881880
3000,2055120209,80841781,1.0913640435e-11,9082169,1230684,4112564
3500,2055813208,80856057,1.0915567695e-11,9546139,1229880,5342444
4000,2058252875,81725371,1.1032925084999999e-11,9559998,-730468,4611976
4500,2066276750,80857034,1.091569959e-11,9577880,1230660,5842636
5000,2064697125,80855601,1.0915506134999999e-11,9531307,1229440,7072076
5500,2065208625,82160643,1.1091686805e-11,10392708,-730192,6341884
6000,2057457250,80963361,1.0930053735e-11,10250246,1230372,7572256
6500,2049065542,80963144,1.093002444e-11,10192530,1229044,8801300
7000,2059319500,80968789,1.0930786515e-11,10426667,1229924,10031224
7500,2051632000,82605816,1.1151785160000001e-11,10783219,-1383860,8647364
8000,2048343917,80981269,1.0932471315000001e-11,10832260,1229940,9877304
8500,2058360584,80982217,1.0932599295e-11,10796711,1230712,11108016
9000,2052211709,80978810,1.093213935e-11,10752370,1230364,12338380
9500,2049952708,80981760,1.09325376e-11,10848231,1230828,13569208
10000,2084435791,83150240,1.12252824e-11,10846418,-2038068,11531140
10500,2054251375,80987526,1.093331601e-11,11035635,1232504,12763644
11000,2063541708,80981189,1.0932460515000001e-11,10744315,1230364,13994008
11500,2057830542,80978934,1.0932156089999999e-11,10756398,1229932,15223940
12000,2067911250,80977995,1.0932029324999999e-11,10725885,1230744,16454684
12500,2069810792,80978916,1.093215366e-11,10755791,1230388,17685072
13000,2062827500,83799001,1.1312865135000001e-11,10774409,-2693364,14991708
13500,2059225875,80993449,1.0934115615e-11,11120467,1246464,16238172
14000,2054034625,81006470,1.093587345e-11,11651318,1247492,17485664
14500,2067167125,81006216,1.093583916e-11,11643056,1248388,18734052
15000,2051414792,80996734,1.0934559089999998e-11,11334871,1247476,19981528
15500,2061063666,80996557,1.0934535195e-11,11329130,1248712,21230240
16000,2050301125,81010603,1.0936431405e-11,11677997,1248388,22478628
16500,2056671541,84587234,1.141927659e-11,11714062,-3449796,19028832
17000,2052668583,81007108,1.0935959580000001e-11,11672026,1247456,20276288
17500,2058011584,81008001,1.0936080135e-11,11701069,1248336,21524624
18000,2050616000,81011929,1.0936610414999999e-11,11694909,1248364,22772988
18500,2070967625,81007083,1.0935956205000001e-11,11671230,1248348,24021336
19000,2058928459,81005626,1.0935759510000001e-11,11623889,1247904,25269240
19500,2066417375,81008142,1.093609917e-11,11705635,1248364,26517604
20000,2049148666,81006872,1.0935927719999999e-11,11664385,1248356,27765960
20500,2052905708,81011900,1.09366065e-11,11693993,1246116,29012076
21000,2052990750,85557727,1.1550293145000001e-11,11557162,-4794552,24217524
21500,2050727667,80995718,1.093442193e-11,11301848,1248836,25466360
22000,2063077208,81006107,1.0935824445e-11,11639524,1249152,26715512
22500,2046976500,81004986,1.093567311e-11,11603065,1247484,27962996
23000,2056428250,81013153,1.0936775655e-11,11699989,1247932,29210928
23500,2073179500,81006664,1.093589964e-11,11657601,1247940,30458868
24000,2051291500,81008267,1.0936116045e-11,11709710,1248836,31707704
24500,2059665916,81007521,1.0936015334999999e-11,11685464,1249168,32956872
25000,2056728500,81008620,1.09361637e-11,11721189,1248836,34205708
25500,2067734375,81014375,1.0936940625e-11,11739701,1249276,35454984
26000,2072166833,81005898,1.0935796229999999e-11,11632718,1247900,36702884
26500,2050320375,86752867,1.1711637045e-11,11623904,-6141720,30561164
27000,2056840583,81007974,1.093607649e-11,11700196,1248720,31809884
27500,2077451750,81016408,1.0937215079999999e-11,11764302,1248836,33058720
28000,2057432167,81006766,1.0935913410000001e-11,11660930,1249624,34308344
28500,2067946958,81006942,1.0935937170000001e-11,11666651,1249184,35557528
29000,2056576000,81021403,1.0937889405000001e-11,12136638,1248360,36805888
29500,2053093250,81023166,1.093812741e-11,12193922,1248380,38054268
30000,2048655084,81028079,1.0938790664999999e-11,12143629,1247468,39301736
30500,2063385541,81025508,1.093844358e-11,12270031,1248372,40550108
31000,2064167291,81022128,1.093798728e-11,12160198,1248804,41798912
31500,2061149334,81021788,1.0937941380000001e-11,12149131,1247908,43046820
32000,2053478125,81023642,1.0938191669999999e-11,12209390,1248812,44295632
32500,2054279333,81028045,1.0938786075000001e-11,12142516,1247940,45543572
33000,2056599166,81023628,1.0938189779999999e-11,12208928,1249252,46792824
33500,2057941167,88285790,1.191858165e-11,12093015,-8157924,38634900
34000,2067849875,81020782,1.0937805569999999e-11,12116462,1247908,39882808
34500,2055800000,81022270,1.0938006450000001e-11,12164811,1248364,41131172
35000,2049405750,81029133,1.0938932955000001e-11,12124010,1247044,42378216
35500,2092485000,81026061,1.0938518235e-11,12287998,1249284,43627500
36000,2050303292,81014723,1.0936987604999999e-11,11919531,1249192,44876692
36500,2055309917,81005871,1.0935792585e-11,11631854,1247484,46124176
37000,2065306875,81008255,1.0936114425e-11,11709330,1248388,47372564
37500,2049347666,81016433,1.0937218455e-11,11711260,1248744,48621308
38000,2065658916,81022504,1.0938038040000002e-11,12172404,1248828,49870136
38500,2064487792,81021376,1.093788576e-11,12135756,1247940,51118076
39000,2057095958,81023947,1.0938232845e-11,12219325,1249168,52367244
39500,2048501292,81028016,1.093878216e-11,12087707,1248388,53615632
40000,2059832875,81022303,1.0938010905000002e-11,12165874,1247916,54863548
40500,2052324958,81025760,1.09384776e-11,12278216,1248820,56112368
41000,2057713667,81018440,1.09374894e-11,12040326,1247460,57359828
41500,2063500875,81021926,1.0937960010000001e-11,12153621,1247044,58606872
42000,2048814542,90130353,1.2167597655e-11,12143338,-10169644,48437228
42500,2052769083,81033817,1.0939565295e-11,12212468,1248804,49686032
43000,2050523584,81030790,1.093915665e-11,12441724,1249140,50935172
43500,2050250042,81022116,1.093798566e-11,12159804,1247940,52183112
44000,2049899875,81019836,1.093767786e-11,12085699,1247808,53430920
44500,2052220667,81027779,1.0938750165000002e-11,12016256,1247908,54678828
45000,2050220125,81020319,1.0937743064999999e-11,12101388,1247468,55926296
45500,2050837500,81026282,1.0938548070000001e-11,12295196,1247940,57174236
46000,2075255708,81004512,1.093560912e-11,11587684,1247932,58422168
46500,2062676916,81005102,1.093568877e-11,11606843,1247940,59670108
47000,2058020958,81016077,1.0937170395e-11,11635919,1248836,60918944
47500,2064464833,81007816,1.093605516e-11,11695052,1249184,62168128
48000,2061427709,81007884,1.0936064340000001e-11,11697251,1248380,63416508
48500,2066754125,81006438,1.0935869129999999e-11,11650254,1249624,64666132
49000,2065429375,81004924,1.093566474e-11,11601067,1247492,65913624
49500,2066383959,81021453,1.0937896155e-11,11810637,1248388,67162012
50000,2056776417,81013458,1.093681683e-11,11878396,1248744,68410756
50500,2050481959,81105800,1.0949283e-11,12670779,1248412,69659168
51000,2053728833,81102088,1.094878188e-11,12550144,1249752,70908920
51500,2057450708,81107365,1.0949494275e-11,12394065,1249300,72158220
52000,2076190792,81104140,1.09490589e-11,12616821,1248856,73407076
52500,3269012375,92500062,1.2487508369999999e-11,12945476,-12860396,60546680
53000,2053259167,81112413,1.0950175755e-11,12885701,1248864,61795544
53500,2068060333,81111417,1.0950041295e-11,12853338,1247504,63043048
54000,2051040292,81125927,1.0952000145000001e-11,12917636,1249328,64292376
54500,2067120500,81112738,1.095021963e-11,12896285,1248416,65540792
55000,2057225333,81111361,1.0950033734999999e-11,12851518,1247968,66788760
55500,2069017375,81113610,1.0950337350000001e-11,12924607,1247968,68036728
56000,2056530083,81123223,1.0951635105e-11,12829766,1248432,69285160
56500,2057284000,81113201,1.0950282135e-11,12911315,1248408,70533568
57000,2056471333,81114001,1.0950390135e-11,12937297,1248424,71781992
57500,2068407875,81114666,1.095047991e-11,12958942,1247536,73029528
58000,2059662083,81099784,1.094847084e-11,12475273,1250904,74280432
58500,2056814792,81108113,1.0949595254999999e-11,12338711,1248872,75529304
59000,2055218459,81098930,1.094835555e-11,12447502,1248396,76777700
59500,2052639375,81111035,1.0949989725e-11,12840919,1248888,78026588
60000,2057232875,81111712,1.095008112e-11,12862917,1249228,79275816
60500,2064388792,81115760,1.09506276e-11,12994485,1249336,80525152
61000,2076353083,81125374,1.095192549e-11,12899686,1249304,81774456
61500,2056880459,81116613,1.0950742754999999e-11,13022208,1249328,83023784
62000,2050589834,81117469,1.0950858315e-11,13050042,1250100,84273884
62500,2052317583,81112074,1.095012999e-11,12874700,1248440,85522324
63000,2059373833,81113641,1.0950341535e-11,12925634,1247544,86769868
63500,2061551792,81128635,1.0952365725000001e-11,13005651,1249328,88019196
64000,2053793542,81115227,1.0950555645e-11,12977162,1249336,89268532
64500,2061385583,81114930,1.0950515549999999e-11,12967501,1248412,90516944
65000,2064277250,81116448,1.095072048e-11,13016835,1249676,91766620
65500,3290072500,95340815,1.2871010025e-11,13091866,-16227464,75539156
66000,2043385667,81127260,1.09521801e-11,13368245,1248888,76788044
66500,2048165750,81127842,1.095225867e-11,13387143,1248888,78036932
67000,2053783083,81128796,1.0952387459999998e-11,13418161,1249692,79286624
67500,2051750417,81126733,1.0952108955e-11,13351109,1248880,80535504
68000,2060759583,81144034,1.0954444589999999e-11,13407499,1247512,81783016
68500,2062090292,81131052,1.0952692019999999e-11,13491457,1249336,83032352
69000,2075770500,81131351,1.0952732385e-11,13501198,1250140,84282492
69500,2072666833,81128315,1.0952322525e-11,13402522,1248432,85530924
70000,2053069916,81126901,1.0952131635e-11,13356553,1247536,86778460
70500,2058273000,81149364,1.0955164139999999e-11,13580719,1250224,88028684
71000,2047837750,81127092,1.095215742e-11,13362778,1247960,89276644
71500,2079030000,81129224,1.095244524e-11,13432064,1249328,90525972
72000,2056873292,81118371,1.0950980085e-11,13079329,1250920,91776892
72500,2074077167,81143509,1.0954373714999999e-11,13390434,1248440,93025332
73000,2052776000,81129807,1.0952523945e-11,13451006,1249336,94274668
73500,2052628875,81114840,1.09505034e-11,12964580,1249664,95524332
74000,2065105292,81118599,1.0951010865e-11,13086746,1248440,96772772
74500,2063294666,81128894,1.0952400689999998e-11,13421344,1247984,98020756
75000,2059342666,81145256,1.095460956e-11,13447220,1247992,99268748
75500,2068748459,81132308,1.095286158e-11,13532305,1249336,100518084
76000,2061378500,81128754,1.0952381789999999e-11,13416800,1249336,101767420
76500,2055431375,81128461,1.0952342235e-11,13407265,1249336,103016756
77000,2053324541,81127462,1.095220737e-11,13374788,1247992,104264748
77500,2073975917,81144144,1.0954459440000001e-11,13411073,1249304,105514052
78000,2070236000,81125815,1.0951985025e-11,13321271,1248416,106762468
78500,2059793416,81126735,1.0952109225e-11,13351173,1248416,108010884
79000,2050579875,81130072,1.0952559719999999e-11,13459614,1249304,109260188
79500,2051749750,81122906,1.095159231e-11,13226741,1248788,110508976
80000,2063636791,81132672,1.095291072e-11,13038222,1248856,111757832
80500,2056905583,81120296,1.095123996e-11,13141894,1249776,113007608
81000,2059354834,81125245,1.0951908075e-11,13302752,1248880,114256488
81500,3270052167,98805956,1.333880406e-11,13470227,-20263440,93993048
82000,2058091667,81145861,1.0954691235e-11,13345794,1247968,95241016
82500,2055022458,81127469,1.0952208315000001e-11,13375010,1248392,96489408
83000,2072269542,81127437,1.0952203995e-11,13373970,1248384,97737792
83500,2058539125,81125645,1.0951962075000001e-11,13315747,1247960,98985752
84000,2061415125,81127991,1.0952278785000001e-11,13391995,1248864,100234616
84500,2053545417,81147498,1.095491223e-11,13398993,1249308,101483924
85000,2056604208,81125911,1.0951997985e-11,13324402,1248412,102732336
85500,2050924834,81130072,1.0952559719999999e-11,13459616,1248432,103980768
86000,2052663000,81125869,1.0951992315000001e-11,13323012,1248432,105229200
86500,2052010791,81147216,1.095487416e-11,13389815,1249336,106478536
87000,2052729625,81128535,1.0952352224999998e-11,13409658,1248424,107726960
87500,2051572458,81129553,1.0952489654999999e-11,13442768,1250472,108977432
88000,2045612084,81112462,1.095018237e-11,12887298,1248856,110226288
88500,2052460416,81116420,1.09507167e-11,13015944,1249296,111475584
89000,2051451042,81146385,1.0954761974999998e-11,13362811,1249296,112724880
89500,2052319042,81128564,1.095235614e-11,13410611,1247992,113972872
90000,2063321959,81129250,1.095244875e-11,13432924,1250116,115222988
90500,2063614375,81129770,1.095251895e-11,13449823,1249336,116472324
91000,2052731166,81126710,1.095210585e-11,13350352,1248440,117720764
91500,2057504459,81147480,1.0954909799999999e-11,13398393,1248424,118969188
92000,2058695625,81126099,1.0952023365e-11,13330507,1247992,120217180
92500,2054245875,81126778,1.095211503e-11,13352580,1249204,121466384
93000,2071791750,81124094,1.0951752689999999e-11,13265350,1248888,122715272
93500,2064815750,81127480,1.09522098e-11,13375375,1250124,123965396
94000,2054664916,81142989,1.0954303514999999e-11,13252443,1248424,125213820
94500,2071307583,81121354,1.095138279e-11,13176305,1250124,126463944
95000,2060697667,81113218,1.095028443e-11,12911874,1248432,127712376
95500,2065062583,81125708,1.0951970580000001e-11,13317790,1249644,128962020
96000,2060704750,81139705,1.0953860175000001e-11,13145692,1248864,130210884
96500,2053883042,81128887,1.0952399745e-11,13421115,1248864,131459748
97000,2074420458,81124198,1.095176673e-11,13268708,1247956,132707704
97500,2053007042,81126930,1.0952135549999998e-11,13357512,1248408,133956112
98000,2050859292,81126521,1.0952080335e-11,13344227,1247960,135204072
98500,2068288917,81144582,1.095451857e-11,13304223,1248416,136452488
99000,2056842875,81128345,1.0952326575e-11,13403476,1249312,137701800
99500,2054620875,81127442,1.0952204669999999e-11,13374163,1248416,138950216
100000,2055727125,81127338,1.095219063e-11,13370758,1248400,140198616
100500,2058132166,81129619,1.0952498565e-11,13444910,1248864,141447480
101000,4749989792,103040480,1.39104648e-11,12891657,-24966092,116481388
101500,2070420708,81114464,1.095045264e-11,12952349,1248440,117729828
102000,2057171041,81126383,1.0952061705e-11,13339729,1249668,118979496
102500,2075867458,81128714,1.095237639e-11,13415496,1248872,120228368
103000,2057648167,81154269,1.0955826315e-11,13472136,1248880,121477248
103500,2065898333,81129444,1.095247494e-11,13439196,1250140,122727388
104000,2054872541,81128339,1.0952325765e-11,13403298,1248440,123975828
104500,2055242042,81128985,1.0952412975e-11,13424282,1248424,125224252
105000,2052977833,81154949,1.0955918114999999e-11,13494248,1249236,126473488
105500,2050245208,81133442,1.095301467e-11,13569155,1248060,127721548
106000,2062121250,81127495,1.0952211825e-11,13375862,1247948,128969496
106500,2076210459,81130451,1.0952610885e-11,13471947,1249784,130219280
107000,2068628458,81128625,1.0952364375e-11,13412583,1248864,131468144
107500,2059429250,81147657,1.0954933695e-11,13257265,1249184,132717328
108000,2059992459,81115999,1.0950659865e-11,13002250,1249336,133966664
108500,2070656000,81115107,1.0950539445e-11,12973261,1248864,135215528
109000,2061827167,81121895,1.0951455825000001e-11,13193880,1249312,136464840
109500,2061073500,81127409,1.0952200215000001e-11,13373064,1248384,137713224
110000,2066934750,81154935,1.0955916225e-11,13493778,1248440,138961664
110500,2051444250,81134475,1.0953154125e-11,13602726,1249328,140210992
111000,2054948042,81127343,1.0952191305e-11,13370937,1247544,141458536
111500,2060397083,81128284,1.095231834e-11,13401511,1247512,142706048
112000,2050192000,81128179,1.0952304165e-11,13398100,1247544,143953592
112500,2050949750,81156090,1.095607215e-11,13531321,1249336,145202928
113000,2057498833,81130194,1.095257619e-11,13463592,1248888,146451816
113500,2055182625,81129375,1.0952465625e-11,13436972,1248796,147700612
114000,2049131083,81127796,1.0952252460000001e-11,13385640,1247964,148948576
114500,2051950500,81128145,1.0952299575e-11,13397005,1249312,150197888
115000,2052926375,81153719,1.0955752065e-11,13454254,1250196,151448084
115500,2057259375,81122364,1.095151914e-11,13209121,1251840,152699924
116000,2066821917,81113670,1.095034545e-11,12926571,1248440,153948364
116500,2057865125,81114390,1.0950442649999999e-11,12949949,1249784,155198148
117000,2063126584,81140317,1.0953942795e-11,13018709,1250580,156448728
117500,2066862542,81130127,1.0952567145e-11,13461410,1248888,157697616
118000,2053417834,81129718,1.0952511929999998e-11,13448111,1248872,158946488
118500,2053933167,81126534,1.095208209e-11,13344650,1249236,160195724
119000,2065553208,81127925,1.0952269875e-11,13389847,1248888,161444612
119500,2055571750,81153121,1.0955671335e-11,13434825,1248880,162693492
120000,2065155625,81130187,1.0952575245e-11,13463362,1250116,163943608
120500,2052364083,81132477,1.0952884395e-11,13537766,1247992,165191600
121000,2065273958,81130871,1.0952667584999999e-11,13485593,1248432,166440032
121500,2087578000,81129016,1.095241716e-11,13425303,1247968,167688000
122000,2051217958,81152041,1.0955525535000001e-11,13399735,1250564,168938564
122500,2055354125,81114606,1.0950471809999999e-11,12956984,1247984,170186548
123000,2065690042,81116702,1.095075477e-11,13025103,1249304,171435852
123500,2072539042,81124539,1.0951812764999999e-11,13279801,1247960,172683812
124000,2060485875,81151689,1.0955478015e-11,13388303,1248400,173932212
124500,2064279417,81130349,1.0952597115e-11,13468627,1249312,175181524
125000,6476955833,108240250,1.461243375e-11,13471865,-31019628,144161896
125500,2066411417,81159877,1.0956583394999999e-11,13472831,1248856,145410752
126000,2067187334,81125349,1.0951922115e-11,13306122,1248860,146659612
126500,2077011625,81126233,1.0952041455e-11,13334867,1248840,147908452
127000,2057688292,81127874,1.0952262989999998e-11,13388195,1248860,149157312
127500,2068666875,81130069,1.0952559315e-11,13459523,1248888,150406200
128000,2057723792,81158115,1.0956345525e-11,13415539,1250116,151656316
128500,2068968958,81125765,1.0951978274999999e-11,13319634,1249296,152905612
129000,2056707125,81126858,1.095212583e-11,13355157,1249312,154154924
129500,2063686583,81128046,1.095228621e-11,13393768,1247948,155402872
130000,2051689625,81120829,1.0951311914999999e-11,13159234,1249236,156652108
130500,2061640250,81161703,1.0956829904999999e-11,13532160,1249668,157901776
131000,2061570833,81127117,1.0952160795e-11,13363586,1248888,159150664
131500,2054288750,81120031,1.0951204185000001e-11,13133287,1249328,160399992
132000,2056133791,81113881,1.0950373935e-11,12933430,1250132,161650124
132500,2049905583,81156591,1.0956139784999999e-11,13366033,1247984,162898108
133000,2062820916,81128853,1.0952395155000001e-11,13419999,1248880,164146988
133500,2082362041,81127203,1.0952172405e-11,13366371,1248764,165395752
134000,2052109167,81125520,1.09519452e-11,13311666,1247536,166643288
134500,2050988625,81129001,1.0952415135e-11,13424832,1248440,167891728
135000,2070812875,81159113,1.0956480254999999e-11,13447991,1248888,169140616
135500,2068877583,81130385,1.0952601975e-11,13469808,1249784,170390400
136000,2053840167,81128429,1.0952337915000002e-11,13406221,1248864,171639264
136500,2069942000,81127303,1.0952185905e-11,13369638,1248416,172887680
137000,2054733791,81129577,1.0952492895000001e-11,13443526,1248768,174136448
137500,2057411792,81159938,1.095659163e-11,13474805,1248856,175385304
138000,2060744334,81126133,1.0952027955000001e-11,13331623,1248416,176633720
138500,2067032000,81128190,1.0952305650000001e-11,13398458,1249312,177883032
139000,2061719875,81129390,1.095246765e-11,13437447,1248416,179131448
139500,2061707625,81138959,1.0953759465e-11,13748451,1248864,180380312
140000,2052945917,81173330,1.095839955e-11,13910036,1248408,181628720
140500,2062308583,81150980,1.09553823e-11,14139130,1249760,182878480
141000,2049330000,81140905,1.0954022175e-11,13811678,1248408,184126888
141500,2056757917,81143965,1.0954435275e-11,13911135,1249304,185376192
142000,2076598958,81142094,1.0954182690000001e-11,13850341,1248888,186625080
142500,2039022083,81141729,1.0954133415e-11,13838458,1248408,187873488
143000,2047271250,81145164,1.0954597139999998e-11,13950103,1249328,189122816
143500,2048950208,81140686,1.0953992609999999e-11,13804589,1248416,190371232
144000,2052542416,81141221,1.0954064835e-11,13821950,1248844,191620076
144500,2057924375,81173080,1.0958365799999999e-11,13901919,1248880,192868956
145000,2055317083,81143120,1.09543212e-11,13883681,1250464,194119420
145500,2063340917,81131359,1.0952733464999999e-11,13501441,1248888,195368308
146000,2057766917,81130201,1.0952577135e-11,13463820,1248864,196617172
146500,2055336708,81141633,1.0954120455e-11,13835374,1248408,197865580
147000,2059094583,81171132,1.095810282e-11,13838592,1247976,199113556
147500,2063735833,81144500,1.0954507500000001e-11,13928521,1249692,200363248
148000,2056175208,81140912,1.095402312e-11,13811913,1248864,201612112
148500,2050198750,81141452,1.095409602e-11,13829464,1248424,202860536
149000,2053820708,81141422,1.095409197e-11,13828498,1249320,204109856
149500,2051906833,81172485,1.0958285475e-11,13882588,1248432,205358288
150000,2071223792,81140527,1.0953971144999998e-11,13799410,1249668,206607956
150500,2056503208,81145945,1.0954702575000001e-11,13975502,1249756,207857712
151000,2062532417,81142018,1.095417243e-11,13847861,1248408,209106120
151500,2061837458,81143382,1.095435657e-11,13892189,1250140,210356260
152000,2068740250,81165395,1.0957328325e-11,13652155,1248788,211605048
152500,2054158625,81126049,1.0952016615e-11,13328878,1248888,212853936
153000,2063097208,81127905,1.0952267175e-11,13389185,1250588,214104524
153500,2066266292,81129499,1.0952482365000001e-11,13441013,1247992,215352516
154000,2054657625,81171275,1.0958122125000001e-11,13843251,1248440,216600956
154500,6493633583,114652764,1.547812314e-11,13903194,-38414068,178186888
155000,2051443334,81140933,1.0954025955e-11,13812592,1248432,179435320
155500,2049661583,81177828,1.095900678e-11,13833178,1248888,180684208
156000,2053277250,81141321,1.0954078335e-11,13825218,1248856,181933064
156500,2065245167,81137617,1.0953578295e-11,13704839,1249684,183182748
157000,2059554250,81135723,1.0953322605e-11,13643292,1247992,184430740
157500,2060388041,81136725,1.0953457875e-11,13675844,1247984,185678724
158000,2059604750,81174797,1.0958597595e-11,13734684,1248888,186927612
158500,2053009000,81138808,1.095373908e-11,13743546,1250048,188177660
159000,2065901875,81124589,1.0951819515e-11,13281419,1248424,189426084
159500,2056700833,81123101,1.0951618635000001e-11,13233084,1247536,190673620
160000,2062285250,81125317,1.0951917794999999e-11,13305082,1249684,191923304
160500,2076342167,81185171,1.0959998085e-11,14071806,1249760,193173064
161000,2070259917,81136947,1.0953487845e-11,13683058,1248864,194421928
161500,2058997166,81133328,1.0952999279999998e-11,13565428,1247952,195669880
162000,2072216208,81133710,1.095305085e-11,13577871,1248416,196918296
162500,2064090167,81133046,1.0952961210000001e-11,13556276,1248856,198167152
163000,2053138208,81133147,1.0952974844999998e-11,13559561,1248864,199416016
163500,2064542500,81131013,1.0952686755e-11,13490202,1248408,200664424
164000,2063761875,81133593,1.0953035055e-11,13574068,1248408,201912832
164500,2067632750,81132998,1.095295473e-11,13554734,1248864,203161696
165000,2080324792,81167797,1.0957652594999999e-11,13507175,1248408,204410104
165500,2058225583,81135972,1.095335622e-11,13651378,1248816,205658920
166000,2071845250,81130261,1.0952585235e-11,13465771,1248864,206907784
166500,2079153416,81129233,1.0952446454999998e-11,13432362,1248772,208156556
167000,2054514458,81142353,1.0954217655000001e-11,13858760,1249320,209405876
167500,2052710917,81181979,1.0959567165e-11,13968076,1250232,210656108
168000,2053197708,81145612,1.095465762e-11,13964670,1249684,211905792
168500,2048602834,81144205,1.0954467675e-11,13918963,1248880,213154672
169000,2070108042,81145785,1.0954680975e-11,13970279,1250132,214404804
169500,2052018292,81142941,1.0954297035e-11,13877856,1248888,215653692
170000,2047941625,81178975,1.0959161625000002e-11,13870451,1248432,216902124
170500,2051489708,81142169,1.0954192815e-11,13852763,1248440,218150564
171000,2055554333,81146091,1.0954722285e-11,13980248,1248856,219399420
171500,2053455750,81142201,1.0954197135e-11,13853815,1249528,220648948
172000,2049704959,81129225,1.0952445375e-11,13432108,1248888,221897836
172500,2059860542,81167537,1.0957617495e-11,13498708,1250232,223148068
173000,2055567625,81129338,1.0952460630000001e-11,13435758,1249220,224397288
173500,2050381084,81129601,1.0952496135e-11,13444332,1248440,225645728
174000,2050817125,81129882,1.095253407e-11,13453448,1247976,226893704
174500,2051137000,81167534,1.095761709e-11,13498620,1250588,228144292
175000,2075557083,81128977,1.0952411895e-11,13424017,1249328,229393620
175500,2186111334,81131089,1.0952697015e-11,13492692,1247180,230640800
176000,2062062541,81131504,1.0952753039999998e-11,13506165,1248864,231889664
176500,2056208834,81129351,1.0952462385e-11,13436178,1248864,233138528
177000,2059905292,81171447,1.0958145345e-11,13625799,1248856,234387384
177500,2051135167,81143820,1.0954415700000001e-11,13906442,1247968,235635352
178000,2060969833,81135161,1.0953246735e-11,13625033,1248404,236883756
178500,2052107583,81145143,1.0954594305e-11,13949427,1248396,238132152
179000,2050650583,81147637,1.0954930995e-11,14030475,1248864,239381016
179500,2051209584,81181735,1.0959534225e-11,13960163,1247968,240628984
180000,2050065208,81147386,1.095489711e-11,14022326,1248864,241877848
180500,2051121500,81146622,1.095479397e-11,13997500,1248888,243126736
181000,2053157417,81140745,1.0954000575e-11,13806477,1247960,244374696
181500,2050603625,81179073,1.0959174855e-11,13873645,1248860,245623556
182000,2051753708,81143828,1.095441678e-11,13906680,1249328,246872884
182500,2046938042,81144600,1.0954521e-11,13931781,1249760,248122644
183000,2063711542,81144445,1.0954500075e-11,13926742,1248864,249371508
183500,2056018833,81143188,1.095433038e-11,13885876,1247960,250619468
184000,2068364792,81172757,1.0958322195e-11,13668357,1247876,251867344
184500,2055122625,81128165,1.0952302275e-11,13397665,1248864,253116208
185000,2073035917,81126740,1.09521099e-11,13351336,1248416,254364624
185500,2058509250,81134664,1.0953179639999999e-11,13608866,1247968,255612592
186000,2066457917,81132001,1.0952820135000002e-11,13522317,1248400,256860992
186500,2067424917,81180939,1.0959426765e-11,13934269,1248880,258109872
187000,2061932542,81143888,1.0954424879999999e-11,13908653,1248416,259358288
187500,2055243917,81146207,1.0954737945e-11,13984014,1248408,260606696
188000,2059565208,81143122,1.095432147e-11,13883745,1248416,261855112
188500,2069754542,81145009,1.0954576215e-11,13945075,1248416,263103528
189000,2067770125,81181174,1.095945849e-11,13941912,1247960,264351488
189500,2067459458,81143274,1.095434199e-11,13888695,1249304,265600792
190000,2065157042,81142927,1.0954295145e-11,13877404,1247968,266848760
190500,2046948042,81145690,1.095466815e-11,13967215,1248848,268097608
191000,8564012375,122615631,1.6553110185e-11,13882464,-47818472,220279136
191500,2063482167,81141770,1.0954138950000001e-11,13839803,1247960,221527096
192000,2060213667,81142238,1.095420213e-11,13855009,1248400,222775496
192500,2059311375,81182252,1.095960402e-11,13700220,1249660,224025156
193000,2059980542,81127939,1.0952271765e-11,13390308,1248848,225274004
193500,2058709875,81129121,1.0952431335e-11,13428719,1248840,226522844
194000,2074553083,81136628,1.095344478e-11,13672704,1247984,227770828
194500,2054006458,81143587,1.0954384245e-11,13898869,1248416,229019244
195000,2066041708,81187958,1.0960374329999999e-11,13885667,1248400,230267644
195500,2069633250,81145644,1.0954661939999998e-11,13965704,1248864,231516508
196000,2057357250,81140768,1.0954003679999998e-11,13807234,1248880,232765388
196500,2065856959,81142839,1.0954283265e-11,13874546,1249752,234015140
197000,2056861334,81185700,1.0960069499999998e-11,13812280,1248432,235263572
197500,2049917750,81142765,1.0954273274999999e-11,13872136,1248432,236512004
198000,2061289959,81144889,1.0954560015e-11,13941192,1249684,237761688
198500,2050234833,81139313,1.0953807255e-11,13759937,1248848,239010536
199000,2049511042,81139304,1.0953806039999999e-11,13759667,1247952,240258488
199500,2055743500,81183855,1.0959820425e-11,13752334,1248852,241507340
200000,2049342000,81142066,1.095417891e-11,13849442,1248872,242756212
200500,2069527416,81133041,1.0952960535e-11,13556118,1250912,244007124
201000,2061451750,81136653,1.0953448155e-11,13673517,1248440,245255564
201500,2077143750,81128642,1.095236667e-11,13413149,1248440,246504004
202000,2052422958,81172493,1.0958286555e-11,13383056,1249292,247753296
202500,2066141084,81127610,1.0952227350000001e-11,13379606,1249236,249002532
203000,2052105375,81143662,1.095439437e-11,13901314,1249752,250252284
203500,2051033333,81143313,1.0954347254999999e-11,13889959,1247992,251500276
204000,2053101292,81144041,1.0954445535000001e-11,13913625,1249776,252750052
204500,2057893041,81184575,1.0959917624999999e-11,13775711,1248772,253998824
205000,2064245458,81141783,1.0954140704999999e-11,13840240,1248888,255247712
205500,2054260125,81144205,1.0954467675e-11,13918963,1247544,256495256
206000,2055882667,81140685,1.0953992475000002e-11,13804542,1248432,257743688
206500,2050985458,81141853,1.0954150155000001e-11,13842515,1249784,258993472
207000,2063245791,81187654,1.096033329e-11,13875779,1250944,260244416
207500,2060428875,81126620,1.09520937e-11,13347442,1248888,261493304
208000,2060869500,81127206,1.0952172809999999e-11,13366473,1248440,262741744
208500,2077647500,81128007,1.0952280945e-11,13392512,1250108,263991852
209000,2111317417,81187757,1.0960347195e-11,13879118,1248860,265240712
209500,2095069750,81141132,1.0954052820000001e-11,13819075,1248888,266489600
210000,2067642167,81142027,1.0954173644999999e-11,13848167,1249196,267738796
210500,2054317083,81146449,1.0954770615e-11,13991887,1248084,268986880
211000,2055938542,81143910,1.095442785e-11,13909367,1249312,270236192
211500,2049045291,81186037,1.0960114994999999e-11,13823241,1247512,271483704
212000,2053770292,81141852,1.095415002e-11,13842461,1249304,272733008
212500,2060758500,81141602,1.0954116269999999e-11,13834354,1248424,273981432
213000,2064715375,81142360,1.09542186e-11,13858974,1248848,275230280
213500,2053005541,81140446,1.0953960210000001e-11,13796787,1249296,276479576
214000,2073446625,81187439,1.0960304265e-11,13868808,1249296,277728872
214500,2050544208,81140183,1.0953924704999999e-11,13788236,1248864,278977736
215000,2049002125,81135823,1.0953336105e-11,13646531,1248768,280226504
215500,2047664542,81129356,1.0952463060000001e-11,13436347,1248888,281475392
216000,2062375125,81177272,1.0958931720000002e-11,13538379,1249296,282724688
216500,2063775250,81145377,1.0954625895e-11,13957026,1249336,283974024
217000,2050323125,81145100,1.09545885e-11,13948030,1250548,285224572
217500,2050521250,81142172,1.0954193220000001e-11,13852867,1248856,286473428
218000,2056909209,81143634,1.0954390590000002e-11,13900383,1248888,287722316
218500,2054688917,81190134,1.096066809e-11,13956369,1247984,288970300
219000,2057789500,81143393,1.0954358054999998e-11,13892565,1249668,290219968
219500,2073347083,81143044,1.095431094e-11,13881198,1248880,291468848
220000,2059346833,81139407,1.0953819945e-11,13763010,1247992,292716840
220500,2061935417,81145571,1.0954652085e-11,13963348,1248432,293965272
221000,2066855542,81187360,1.0960293600000002e-11,13866239,1248888,295214160
221500,2060612042,81141831,1.0954147184999999e-11,13841778,1247984,296462144
222000,2053746875,81142525,1.0954240875e-11,13864345,1251368,297713512
222500,2056338459,81126753,1.0952111655e-11,13351772,1248432,298961944
223000,2050840500,81127340,1.09521909e-11,13370837,1249328,300211272
223500,2054108584,81171518,1.095815493e-11,13351377,1249660,301460932
224000,2063008791,81141783,1.0954140704999999e-11,13840245,1248432,302709364
224500,2057486708,81143624,1.0954389240000001e-11,13900060,1247984,303957348
225000,2056772209,81144577,1.0954517894999999e-11,13931033,1249336,305206684
225500,2053783917,81144777,1.0954544895000002e-11,13937555,1250132,306456816
226000,2056289958,81141542,1.0954108169999999e-11,13832403,1249336,307706152
226500,2051429708,81140408,1.0953955080000001e-11,13795542,1248440,308954592
227000,2053815833,81142502,1.095423777e-11,13863601,1249668,310204260
227500,2060001750,81139174,1.095378849e-11,13755454,1248848,311453108
228000,2068496834,81187463,1.0960307505000001e-11,13869576,1248880,312701988
228500,2052959417,81140342,1.095394617e-11,13793400,1250944,313952932
229000,2060107959,81128764,1.095238314e-11,13417109,1249336,315202268
229500,2050018916,81128278,1.095231753e-11,13401308,1247992,316450260
230000,2051686875,81128373,1.0952330355000001e-11,13404401,1249692,317699952
230500,2050444834,81185779,1.0960080165e-11,13814862,1247992,318947944
231000,2062497459,81134331,1.0953134685e-11,13598029,1248416,320196360
231500,2050237708,81133172,1.095297822e-11,13560371,1248400,321444760
232000,2052775833,81134863,1.0953206505e-11,13615340,1248864,322693624
232500,2050118792,81133728,1.0953053279999999e-11,13578430,1247512,323941136
233000,2049305208,81179448,1.095922548e-11,13609100,1248400,325189536
233500,2049617583,81134003,1.0953090405e-11,13587394,1248416,326437952
234000,2136540458,81134548,1.0953163980000001e-11,13605093,1249300,327687252
234500,2123182417,81132692,1.095291342e-11,13544759,1248384,328935636
235000,2071664875,81179373,1.0959215355e-11,13606653,1248416,330184052
235500,2082114875,81136470,1.0953423449999999e-11,13667556,1248864,331432916
236000,11096506667,132373959,1.7870484465000002e-11,13271765,-59253992,272178924
236500,2058347042,81130927,1.0952675145e-11,13487415,1249304,273428228
237000,2064048000,81144433,1.0954498454999999e-11,13926340,1248408,274676636
237500,2054030875,81142726,1.095426801e-11,13870879,1247080,275923716
238000,2061587834,81143159,1.0954326465000001e-11,13884964,1247536,277171252
238500,2052926000,81199920,1.0961989200000001e-11,13933777,1248860,278420112
239000,2061745541,81145649,1.0954662615e-11,13965878,1248860,279668972
239500,2092408834,81144665,1.0954529775e-11,13933894,1248848,280917820
240000,2052286958,81143981,1.0954437435e-11,13911685,1248416,282166236
240500,2054820708,81146613,1.0954792755e-11,13997211,1249776,283416012
241000,2063847375,81141925,1.0954159875e-11,13844849,1248408,284664420
241500,2054081042,81141448,1.095409548e-11,13829334,1247992,285912412
242000,2062907125,81143971,1.0954436084999999e-11,13911327,1250116,287162528
242500,2069082875,81141869,1.0954152314999999e-11,13843043,1248432,288410960
243000,2071076708,81191752,1.0960886519999999e-11,13668325,1250096,289661056
243500,2067281167,81125382,1.0951926570000002e-11,13307196,1248432,290909488
244000,2116971750,81130051,1.0952556885e-11,13458954,1250116,292159604
244500,2054405791,81138345,1.0953676575e-11,13728509,1247520,293407124
245000,2053027542,81142671,1.0954260585e-11,13869090,1249320,294656444
245500,2060585167,81202343,1.0962316305e-11,14012523,1249336,295905780
246000,2057672000,81141302,1.095407577e-11,13824601,1247536,297153316
246500,2061797667,81142688,1.095426288e-11,13869644,1248424,298401740
247000,2051693167,81144140,1.09544589e-11,13916829,1250100,299651840
247500,2072839834,81140276,1.095393726e-11,13791256,1248440,300900280
248000,2090293791,81198243,1.0961762805e-11,13879258,1248888,302149168
248500,2073085875,81144854,1.095455529e-11,13940041,1249684,303398852
249000,2051474458,81138326,1.0953674010000001e-11,13727873,1248424,304647276
249500,2051754250,81142920,1.09542942e-11,13877177,1248888,305896164
250000,2061122208,81187920,1.09603692e-11,13543785,1248780,307144944
250500,2062350916,81127236,1.095217686e-11,13367436,1249668,308394612
251000,2098262875,81137000,1.0953495000000001e-11,13684773,1248864,309643476
251500,2091912791,81133972,1.095308622e-11,13586381,1247984,310891460
252000,2071558792,81142115,1.0954185525e-11,13851008,1250108,312141568
252500,2159144167,81195266,1.0961360909999999e-11,13782514,1249336,313390904
253000,2058370500,81140456,1.095396156e-11,13797094,1247536,314638440
253500,2059083667,81140201,1.0953927134999999e-11,13788819,1247992,315886432
254000,2053142083,81141613,1.0954117755e-11,13834725,1248772,317135204
254500,2060601292,81196346,1.0961506709999999e-11,13817608,1247976,318383180
255000,2064431916,81141990,1.0954168649999999e-11,13846974,1248440,319631620
255500,2060119250,81145517,1.0954644795e-11,13961592,1248432,320880052
256000,2051922250,81141421,1.0954091835e-11,13828471,1248412,322128464
256500,2062498625,81140170,1.0953922950000001e-11,13787813,1248440,323376904
257000,2051150250,81194203,1.0961217404999998e-11,13747962,1250108,324627012
257500,2057532834,81127262,1.095218037e-11,13368301,1248864,325875876
258000,2050120500,81141342,1.095408117e-11,13825908,1248404,327124280
258500,2052734292,81144423,1.0954497105e-11,13926033,1248864,328373144
259000,2060920083,81140691,1.0953993285e-11,13804731,1247512,329620656
259500,2052271750,81199314,1.096190739e-11,13914072,1249752,330870408
260000,2053346333,81141837,1.0954147995e-11,13842002,1248408,332118816
260500,2052357584,81146930,1.095483555e-11,14007507,1247968,333366784
261000,2206865458,81140838,1.095401313e-11,13809534,1249308,334616092
261500,2086922375,81195084,1.0961336340000001e-11,13776581,1248408,335864500
262000,2062647625,81142199,1.0954196865e-11,13853756,1249328,337113828
262500,2056733083,81141137,1.0954053495e-11,13819218,1248416,338362244
263000,2055083000,81145485,1.0954640475000001e-11,13960536,1249692,339611936
263500,2052331542,81141617,1.0954118295000001e-11,13834847,1247544,340859480
264000,2051338250,81197167,1.0961617544999999e-11,13844297,1249784,342109264
264500,2048672708,81142352,1.0954217520000001e-11,13858712,1248888,343358152
265000,2066030583,81145361,1.0954623734999999e-11,13956513,1259336,344617488
265500,2063364375,81155503,1.0955992905e-11,14286134,1268132,345885620
266000,2056783000,81137872,1.0953612719999999e-11,13713124,1266440,347152060
266500,2051608917,81193699,1.0961149364999999e-11,13731578,1266432,348418492
267000,2049702541,81141280,1.09540728e-11,13823888,1267692,349686184
267500,2069398417,81153967,1.0955785545e-11,14236198,1267296,350953480
268000,2056846541,81155404,1.095597954e-11,14282925,1266440,352219920
268500,2049692042,81155634,1.0956010589999998e-11,14290384,1267692,353487612
269000,2416307041,81210943,1.0963477304999999e-11,14292021,1266880,354754492
269500,2089247666,81155933,1.0956050954999998e-11,14300098,1267320,356021812
270000,2056337084,81153319,1.0955698065e-11,14215157,1267208,357289020
270500,2058831709,81157597,1.0956275595e-11,14354188,1265992,358555012
271000,2060457792,81209081,1.0963225935e-11,14231496,1267312,359822324
271500,2060648916,81149617,1.0955198295e-11,14094837,1266796,361089120
272000,2054348334,81139079,1.0953775665e-11,13752361,1266440,362355560
272500,2052624000,81138053,1.0953637154999999e-11,13718995,1266416,363621976
273000,2112865958,81151728,1.095548328e-11,14163438,1267308,364889284
273500,2055717375,81212702,1.096371477e-11,14349193,1267776,366157060
274000,2049650833,81153306,1.095569631e-11,14214740,1265960,367423020
274500,2050069708,81153832,1.095576732e-11,14231834,1266416,368689436
275000,2051866000,81156575,1.0956137625000001e-11,14320983,1266856,369956292
275500,2051518542,81156452,1.0956121020000001e-11,14316958,1266400,371222692
276000,2056310834,81208356,1.096312806e-11,14207940,1267336,372490028
276500,2052647917,81154552,1.095586452e-11,14255234,1266880,373756908
277000,2049494417,81155304,1.095596604e-11,14279659,1266440,375023348
277500,2050921958,81156499,1.0956127365e-11,14318508,1268116,376291464
278000,2050654625,81208486,1.0963145609999998e-11,14212169,1266408,377557872
278500,2049807166,81154371,1.0955840085e-11,14249347,1266880,378824752
279000,2051574250,81155555,1.0955999925e-11,14287811,1266440,380091192
279500,2057920500,81146314,1.095475239e-11,13987505,1268488,381359680
280000,2067402083,81143093,1.0954317555e-11,13882791,1267336,382627016
280500,2056046875,81210756,1.096345206e-11,14285927,1266872,383893888
281000,2057008250,81151990,1.095551865e-11,14171975,1266872,385160760
281500,2053971042,81154499,1.0955857365e-11,14253488,1265984,386426744
282000,2062773500,81153100,1.0955668499999999e-11,14208028,1265992,387692736
282500,2061110542,81152348,1.0955566980000001e-11,14183592,1268132,388960868
283000,2055064042,81208684,1.0963172340000001e-11,14218598,1267328,390228196
283500,2064309958,81153092,1.095566742e-11,14207767,1265984,391494180
284000,2051634125,81152813,1.0955629754999999e-11,14198715,1267692,392761872
284500,2056541708,81153661,1.0955744235e-11,14226250,1266880,394028752
285000,2110013208,81153085,1.0955666475e-11,14207540,1266880,395295632
285500,2056251167,81212545,1.0963693575e-11,14344090,1267684,396563316
286000,2060040250,81148063,1.0954988504999999e-11,14044339,1266316,397829632
286500,2056969875,81136924,1.095348474e-11,13682316,1266416,399096048
287000,2045644334,81137007,1.0953495945e-11,13685013,1265960,400362008
287500,2055068000,81193759,1.0961157464999999e-11,13733532,1266416,401628424
288000,2244877292,81143905,1.0954427175e-11,13909195,1266408,402894832
288500,2052279250,81152480,1.0955584799999999e-11,14187869,1266416,404161248
289000,2057729167,81152319,1.0955563064999999e-11,14182652,1266416,405427664
289500,2054107833,81154647,1.0955877344999999e-11,14258321,1266404,406694068
290000,2074998916,81211390,1.0963537649999999e-11,14306554,1267312,407961380
290500,2061653584,81155639,1.0956011265e-11,14290557,1265520,409226900
291000,17706446417,144396899,1.9493581365e-11,14139506,-73619572,335607328
291500,2082221041,81153233,1.0955686455e-11,14212348,1266440,336873768
292000,2130097542,81154847,1.0955904345000001e-11,14264813,1266864,338140632
292500,2093605333,81156805,1.0956168675e-11,14328442,1266424,339407056
293000,2078205666,81156466,1.095612291e-11,14317443,1266880,340673936
293500,2058470834,81223041,1.0965110534999999e-11,14267389,1265984,341939920
294000,14314016250,81244568,1.0968016679999998e-11,14745651,1268496,343208416
294500,2051707416,81166761,1.0957512735e-11,14652022,1266408,344474824
295000,2057124708,81167429,1.0957602915e-11,14673709,1265992,345740816
295500,2066208833,81240953,1.0967528655e-11,14849514,1266880,347007696
296000,2226698917,81159699,1.0956559364999999e-11,14422495,1267320,348275016
296500,2064445041,81156341,1.0956106035e-11,14313354,1266888,349541904
297000,2072388333,81157375,1.0956245624999999e-11,14346979,1267656,350809560
297500,2048838250,81159800,1.0956573e-11,14425772,1266412,352075972
298000,2062042209,81226137,1.0965528495000001e-11,14368014,1266400,353342372
298500,2062783584,81157734,1.0956294089999999e-11,14358652,1266432,354608804
299000,2060920500,81157931,1.0956320685e-11,14365038,1267336,355876140
299500,2071166750,81158746,1.0956430710000001e-11,14391526,1267336,357143476
300000,2057298000,81227432,1.096570332e-11,14410073,1265960,358409436
300500,2058493958,81157547,1.0956268845e-11,14352553,1266856,359676292
301000,2081620875,81156819,1.0956170565e-11,14328902,1265960,360942252
301500,2060201000,81165696,1.095736896e-11,14617399,1265992,362208244
302000,2052342500,81169453,1.0957876155e-11,14739509,1267668,363475912
302500,2050539458,81238819,1.0967240565e-11,14780154,1266432,364742344
303000,2055047792,81169351,1.0957862385000001e-11,14736181,1266440,366008784
303500,2057503375,81171542,1.0958158170000001e-11,14807403,1267244,367276028
304000,2239957292,81173253,1.0958389154999999e-11,14863013,1267336,368543364
304500,2633235334,81239931,1.0967390684999999e-11,14816289,1266872,369810236
305000,2077214208,81169037,1.0957819995e-11,14725980,1267244,371077480
305500,2055297959,81172018,1.0958222429999999e-11,14822860,1265636,372343116
306000,2063447542,81170969,1.0958080815e-11,14788763,1265968,373609084
306500,2055175917,81170122,1.095796647e-11,14761255,1266408,374875492
307000,2052508375,81238988,1.096726338e-11,14785672,1266848,376142340
307500,2070259291,81169909,1.0957937715e-11,14754320,1267220,377409560
308000,2054790708,81157820,1.09563057e-11,14361423,1266856,378676416
308500,2053159500,81156736,1.0956159360000001e-11,14326215,1266416,379942832
309000,2068701084,81160656,1.095668856e-11,14453604,1265968,381208800
309500,2065850542,81240773,1.0967504354999999e-11,14843662,1266864,382475664
310000,2055275500,81161927,1.0956860144999999e-11,14494922,1266400,383742064
310500,2076195750,81173776,1.095845976e-11,14879987,1266856,385008920
311000,2068058875,81171865,1.0958201775e-11,14817901,1265936,386274856
311500,2079633000,81239456,1.0967326560000001e-11,14800853,1268116,387542972
312000,2103619167,81169458,1.095787683e-11,14739661,1267336,388810308
312500,2071991417,81170917,1.0958073794999998e-11,14787094,1266872,390077180
313000,2137395000,81170705,1.0958045175e-11,14780185,1268140,391345320
313500,2050819833,81171336,1.0958130360000001e-11,14800708,1266880,392612200
314000,2052941458,81241491,1.0967601284999999e-11,14866997,1266432,393878632
314500,2053563625,81169738,1.095791463e-11,14748756,1267600,395146232
315000,2050776750,81154829,1.0955901915000001e-11,14264241,1265544,396411776
315500,2050299500,81158905,1.0956452175e-11,14396700,1265188,397676964
316000,2058429500,81225327,1.0965419145e-11,14341669,1266848,398943812
316500,2053475583,81154920,1.09559142e-11,14267182,1267236,400211048
317000,2060916167,81161620,1.0956818699999999e-11,14484935,1267784,401478832
317500,2053467333,81169257,1.0957849695e-11,14733123,1265984,402744816
318000,2049330500,81172895,1.0958340825e-11,14851362,1268560,404013376
318500,2057418791,81237340,1.09670409e-11,14732078,1265968,405279344
319000,2056467583,81170733,1.0958048955000001e-11,14781114,1265992,406545336
319500,2045546000,81171567,1.0958161545e-11,14808202,1267684,407813020
320000,2049210458,81170806,1.095805881e-11,14783479,1266432,409079452
320500,2073329583,81175266,1.0958660909999999e-11,14928443,1265960,410345412
321000,2374735083,81240842,1.096751367e-11,14845921,1266416,411611828
321500,2205067333,81171393,1.0958138055e-11,14802574,1268488,412880316
322000,2055695125,81153000,1.0955655e-11,14204777,1265544,414145860
322500,2054827917,81152624,1.0955604240000001e-11,14192570,1266880,415412740
323000,2052390583,81224281,1.0965277935e-11,14307693,1268116,416680856
323500,2056505375,81173535,1.0958427225e-11,14872182,1267336,417948192
324000,2057525417,81169138,1.095783363e-11,14729284,1265984,419214176
324500,2060014583,81171259,1.0958119965e-11,14798196,1268132,420482308
325000,2051915041,81170720,1.09580472e-11,14780685,1266888,421749196
325500,2056677666,81246016,1.096821216e-11,15014050,1267328,423016524
326000,2055138083,81170726,1.0958048009999999e-11,14780868,1266864,424283388
326500,2057757875,81173546,1.095842871e-11,14872519,1266864,425550252
327000,2059481292,81172250,1.095825375e-11,14830418,1267312,426817564
327500,2062169917,81173661,1.0958444235e-11,14876256,1266832,428084396
328000,2050690875,81240443,1.0967459805e-11,14832935,1265968,429350364
328500,2049550167,81171620,1.0958168700000001e-11,14809923,1267312,430617676
329000,2049675208,81167901,1.0957666635e-11,14689070,1267212,431884888
329500,2054253958,81156769,1.0956163815e-11,14327258,1266408,433151296
330000,2052580667,81171565,1.0958161275e-11,14808144,1265952,434417248
330500,2047990917,81241701,1.0967629635000001e-11,14873820,1266856,435684104
331000,2050387125,81170215,1.0957979025e-11,14764265,1267328,436951432
331500,2069745541,81159704,1.0956560039999999e-11,14422657,1265968,438217400
332000,2102814250,81157990,1.095632865e-11,14366965,1267304,439484704
332500,2068757625,81238933,1.0967255955000001e-11,14783882,1265968,440750672
333000,2059624958,81169531,1.0957886684999999e-11,14742043,1266872,442017544
333500,2053441459,81171158,1.0958106329999998e-11,14794918,1266856,443284400
334000,2056128375,81174626,1.0958574510000001e-11,14907636,1268200,444552600
334500,2049735541,81171284,1.095812334e-11,14799021,1266856,445819456
335000,2059290542,81240289,1.0967439015e-11,14827934,1267312,447086768
335500,2054291917,81173326,1.095839901e-11,14865384,1266408,448353176
336000,2049668208,81171069,1.0958094315e-11,14792039,1266440,449619616
336500,2055704125,81168615,1.0957763025e-11,14712262,1266408,450886024
337000,2074456000,81168879,1.0957798665e-11,14720848,1266416,452152440
337500,2051230583,81234991,1.0966723785e-11,14655751,1268108,453420548
338000,2065256000,81159348,1.095651198e-11,14411102,1266416,454686964
338500,2051595250,81170420,1.09580067e-11,14770924,1266416,455953380
339000,2050144500,81156588,1.095613938e-11,14321405,1266416,457219796
339500,2064568000,81151818,1.0955495430000002e-11,14166357,1266864,458486660
340000,2112659583,81225311,1.0965416985000002e-11,14341144,1266880,459753540
340500,2067649209,81161619,1.0956818565e-11,14484887,1266416,461019956
341000,2051664542,81170428,1.095800778e-11,14771180,1266856,462286812
341500,2056448125,81173205,1.0958382675000001e-11,14861429,1266856,463553668
342000,2068934833,81240242,1.096743267e-11,14826397,1266864,464820532
342500,2079674167,81171940,1.09582119e-11,14820324,1265960,466086492
343000,2069952292,81170869,1.0958067315e-11,14785533,1266856,467353348
343500,2054181584,81170643,1.0958036805e-11,14778170,1265508,468618856
344000,2048095458,81169475,1.0957879125e-11,14740227,1265064,469883920
344500,2060743208,81239907,1.0967387445e-11,14815526,1265968,471149888
345000,2067203042,81170053,1.0957957154999998e-11,14759009,1265992,472415880
345500,2049627125,81173313,1.0958397255e-11,14864940,1266864,473682744
346000,2052782542,81162563,1.0956946005e-11,14515579,1267660,474950404
346500,2050941958,81151424,1.095544224e-11,14153570,1267244,476217648
347000,2051931000,81220326,1.096474401e-11,14179129,1266440,477484088
347500,2053152292,81160277,1.0956637395e-11,14441296,1266880,478750968
348000,2072057417,81169969,1.0957945815e-11,14756256,1266440,480017408
348500,2056358125,81168716,1.095777666e-11,14715543,1268124,481285532
349000,2086347792,81168616,1.095776316e-11,14712306,1267776,482553308
349500,2061905834,81237923,1.0967119605e-11,14751034,1267692,483821000
350000,2057056292,81167194,1.0957571189999999e-11,14666079,1266880,485087880
350500,2055510250,81170665,1.0958039775e-11,14778905,1265636,486353516
351000,2045051084,81168834,1.0957792590000001e-11,14719397,1268224,487621740
351500,2049581916,81235790,1.096683165e-11,14681712,1266880,488888620
352000,2050395375,81168682,1.095777207e-11,14714447,1266400,490155020
352500,2053413042,81171533,1.0958156954999999e-11,14807093,1266424,491421444
353000,2059070208,81169379,1.0957866165e-11,14737101,1268024,492689468
353500,2049427292,81155045,1.0955931075e-11,14271262,1267292,493956760
354000,2058472416,81227992,1.096577892e-11,14428272,1265968,495222728
354500,2054568667,81171425,1.0958142375e-11,14803584,1266440,496489168
355000,2051680417,81170747,1.0958050845e-11,14781570,1265976,497755144
355500,2054874666,81173506,1.0958423310000001e-11,14871225,1266764,499021908
356000,2059045875,81170502,1.095801777e-11,14773614,1266848,500288756
356500,2058593625,81236721,1.0966957334999999e-11,14711989,1266440,501555196
357000,2116822125,81171739,1.0958184765e-11,14813810,1266788,502821984
357500,2243833084,81170462,1.095801237e-11,14772315,1266888,504088872
358000,17735009166,158991101,2.1463798634999997e-11,14744232,-91216076,412872796
358500,2057329458,81169892,1.0957935419999998e-11,14753771,1266440,414139236
359000,2057562208,81170035,1.0957954725000001e-11,14758414,1267212,415406448
359500,2082649375,81169356,1.095786306e-11,14736354,1267776,416674224
360000,2065849333,81164591,1.0957219785e-11,14581496,1268588,417942812
360500,2060437834,81243815,1.0967915025e-11,14433650,1267668,419210480
361000,2052467417,81165914,1.095739839e-11,14624489,1266416,420476896
361500,2063350125,81162043,1.0956875805e-11,14498670,1265984,421742880
362000,2056819459,81168551,1.0957754385e-11,14710176,1267692,423010572
362500,2051489375,81167567,1.0957621545e-11,14678221,1266852,424277424
363000,6485231125,81167551,1.0957619385e-11,14677683,1266440,425543864
363500,2054647958,81167352,1.095759252e-11,14671222,1265992,426809856
364000,2052906458,81253460,1.09692171e-11,14747108,1268588,428078444
364500,2056449791,81168393,1.0957733055e-11,14705050,1265984,429344428
365000,2094669458,81168707,1.0957775444999999e-11,14715275,1266888,430611316
365500,2201164000,81173396,1.095840846e-11,14867644,1268108,431879424
366000,2054558667,81165490,1.095734115e-11,14610715,1266400,433145824
366500,2054149917,81255148,1.096944498e-11,14801982,1268108,434413932
367000,2051842500,81162347,1.0956916845e-11,14508552,1266864,435680796
367500,2052324708,81160625,1.0956684375000001e-11,14452615,1266400,436947196
368000,2053617541,81160753,1.0956701655e-11,14456742,1265976,438213172
368500,2052664416,81243128,1.096782228e-11,14411327,1266864,439480036
369000,2049954750,81162740,1.09569699e-11,14521330,1266852,440746888
369500,2055200125,81162004,1.095687054e-11,14497415,1266416,442013304
370000,2052511000,81161936,1.095686136e-11,14495192,1265544,443278848
370500,2051690125,81162020,1.09568727e-11,14497923,1266864,444545712
371000,2054224458,81236606,1.096694181e-11,14199346,1266440,445812152
371500,2057250291,81157018,1.0956197429999998e-11,14335373,1265544,447077696
372000,2061103000,81171992,1.0958218919999999e-11,14822033,1267776,448345472
372500,2074340708,81171829,1.0958196915e-11,14816727,1265992,449611464
373000,2074614541,81172145,1.0958239575000001e-11,14827001,1265984,450877448
373500,2061766209,81253665,1.0969244775e-11,14753776,1266764,452144212
374000,2054074750,81169489,1.0957881015e-11,14740671,1267328,453411540
374500,2347393375,81173882,1.0958474069999999e-11,14883445,1267760,454679300
375000,2111709125,81171287,1.0958123745e-11,14799100,1265976,455945276
375500,2049032959,81258628,1.0969914779999999e-11,14915064,1267244,457212520
376000,2062193542,81169305,1.0957856175e-11,14734714,1266416,458478936
376500,2052473458,81165846,1.095738921e-11,14622285,1265976,459744912
377000,2058638125,81168914,1.095780339e-11,14722005,1265992,461010904
377500,2058325542,81155629,1.0956009914999999e-11,14290233,1268020,462278924
378000,2050323500,81239358,1.0967313330000001e-11,14288810,1266440,463545364
378500,2054492125,81162438,1.095692913e-11,14511507,1266872,464812236
379000,2105753833,81172167,1.0958242545e-11,14827721,1267244,466079480
379500,2053440875,81167049,1.0957551615e-11,14661364,1266432,467345912
380000,2061137167,81171097,1.0958098095000001e-11,14792940,1267776,468613688
380500,2052251417,81261205,1.0970262675e-11,14998808,1266316,469880004
381000,2054797500,81169845,1.0957929075e-11,14752229,1266440,471146444
381500,2049337125,81169634,1.095790059e-11,14745390,1265536,472411980
382000,2062887084,81168990,1.0957813650000001e-11,14724464,1265960,473677940
382500,2052370458,81254050,1.096929675e-11,14766285,1266880,474944820
383000,2087182417,81170182,1.095797457e-11,14763207,1267328,476212148
383500,2196802250,81170546,1.095802371e-11,14775042,1266408,477478556
384000,2053127583,81169546,1.095788871e-11,14742528,1265960,478744516
384500,2074089208,81165212,1.095730362e-11,14601673,1267668,480012184
385000,2049587875,81237849,1.0967109614999999e-11,14239762,1266856,481279040
385500,2054276959,81156991,1.0956193784999999e-11,14334490,1266888,482545928
386000,2052048500,81155273,1.0955961855e-11,14278670,1266852,483812780
386500,2054599458,81160769,1.0956703815e-11,14457258,1266440,485079220
387000,2051816833,81169065,1.0957823775e-11,14726876,1266432,486345652
387500,2077834959,81254449,1.0969350615e-11,14779256,1267692,487613344
388000,2048965792,81167689,1.0957638015e-11,14682156,1266412,488879756
388500,2060701791,81169057,1.0957822695e-11,14726642,1266408,490146164
389000,2055760583,81169081,1.0957825935e-11,14727435,1266860,491413024
389500,2039533208,81171585,1.0958163975e-11,14808805,1266880,492679904
390000,2047718667,81169327,1.0957859144999999e-11,14735398,1265992,493945896
390500,2049143458,81174249,1.0958523615e-11,14895361,1268580,495214476
391000,2053205875,81170981,1.0958082435e-11,14789183,1267336,496481812
391500,2352189083,81170071,1.0957959584999999e-11,14759580,1266440,497748252
392000,2358704834,81252043,1.0969025805e-11,14701061,1268040,499016292
392500,2066283125,81172816,1.0958330159999999e-11,14848814,1266872,500283164
393000,2055045791,81186623,1.0960194105e-11,15297526,1266424,501549588
393500,2054041875,81186178,1.0960134029999999e-11,15283075,1266432,502816020
394000,2055401209,81270180,1.0971474300000002e-11,15290504,1268132,504084152
394500,2067808667,81187638,1.096033113e-11,15330508,1266432,505350584
395000,2054764833,81187919,1.0960369065e-11,15339663,1267784,506618368
395500,2079228708,81191814,1.0960894889999998e-11,15466234,1269036,507887404
396000,2073028833,81187056,1.096025256e-11,15311592,1267644,509155048
396500,2053616250,81266917,1.0971033795000001e-11,15184458,1266416,510421464
397000,2071261083,81183933,1.0959830955000001e-11,15210105,1267760,511689224
397500,2053181500,81182329,1.0959614414999998e-11,15157976,1266840,512956064
398000,2050735875,81183599,1.0959785865e-11,15199248,1266856,514222920
398500,2054744459,81174924,1.0958614739999999e-11,14917314,1268024,515490944
399000,2055881042,81239617,1.0967348295e-11,14297224,1266856,516757800
399500,2054176417,81170955,1.0958078924999999e-11,14788334,1266872,518024672
400000,2178012792,81171449,1.0958145615e-11,14804394,1266860,519291532
400500,2635385666,81171302,1.095812577e-11,14799586,1266856,520558388
401000,2067346792,81250360,1.09687986e-11,14646363,1266408,521824796
401500,2047598042,81165517,1.0957344794999999e-11,14611596,1267328,523092124
402000,2063197125,81169269,1.0957851314999998e-11,14733527,1266788,524358912
402500,2069490875,81171171,1.0958108084999999e-11,14795345,1267336,525626248
403000,2050024958,81170021,1.0957952835e-11,14757954,1267328,526893576
403500,2053518041,81257248,1.0969728480000001e-11,14870219,1268580,528162156
404000,2053842708,81170446,1.095801021e-11,14771794,1266888,529429044
404500,2055161000,81168012,1.095768162e-11,14692663,1266440,530695484
405000,2071539834,81170382,1.095800157e-11,14769693,1267656,531963140
405500,2078745375,81257657,1.0969783695e-11,14883498,1266524,533229664
406000,2075015500,81167631,1.0957630185000001e-11,14680304,1266772,534496436
406500,2061878291,81156459,1.0956121965e-11,14317202,1265968,535762404
407000,2049305166,81157455,1.0956256425000002e-11,14349575,1266852,537029256
407500,2054886083,81167964,1.095767514e-11,14691119,1266888,538296144
408000,2074276708,81256955,1.0969688925e-11,14860712,1267752,539563896
408500,2070817292,81170787,1.0958056245e-11,14782853,1266864,540830760
409000,2116823000,81171877,1.0958203394999999e-11,14818279,1267304,542098064
409500,2057797625,81171273,1.0958121855e-11,14798655,1266416,543364480
410000,2056661250,81171053,1.0958092154999999e-11,14791506,1266864,544631344
410500,2059456875,81256140,1.0969578900000001e-11,14834212,1265960,545897304
411000,2080833416,81170443,1.0958009805e-11,14771671,1266864,547164168
411500,2066864959,81170900,1.09580715e-11,14786533,1266864,548431032
412000,2054400167,81167341,1.0957591035e-11,14670867,1265968,549697000
412500,2057280125,81255011,1.0969426485e-11,14797514,1266856,550963856
413000,2068527917,81169925,1.0957939874999999e-11,14754835,1266408,552230264
413500,2066395584,81170801,1.0958058135000001e-11,14783303,1266864,553497128
414000,2058458000,81169456,1.095787656e-11,14739599,1265968,554763096
414500,2062475042,81165969,1.0957405815e-11,14626281,1268100,556031196
415000,2051769542,81239457,1.0967326695e-11,14292007,1267320,557298516
415500,2056694166,81166741,1.0957510035e-11,14651350,1267336,558565852
416000,2070193375,81169998,1.095794973e-11,14757206,1266864,559832716
416500,2102747333,81169536,1.095788736e-11,14742212,1266880,561099596
417000,2098601625,81173086,1.095836661e-11,14857574,1268216,562367812
417500,2281048417,81253656,1.0969243560000001e-11,14753477,1265992,563633804
418000,2089712250,81171529,1.0958156415e-11,14806965,1267244,564901048
418500,2051515875,81170712,1.095804612e-11,14780435,1266888,566167936
419000,2051769208,81169182,1.095783957e-11,14730705,1266412,567434348
419500,2057069583,81255240,1.09694574e-11,14804954,1266864,568701212
420000,2080508083,81170239,1.0957982265e-11,14765045,1266408,569967620
420500,2059585000,81174209,1.0958518215e-11,14894070,1266432,571234052
421000,2063121125,81168692,1.095777342e-11,14714761,1265992,572500044
421500,2058526959,81255031,1.0969429185e-11,14798163,1266880,573766924
422000,2076593000,81169819,1.0957925565000001e-11,14751395,1265992,575032916
422500,2051645834,81156568,1.095613668e-11,14320753,1268048,576300964
423000,2057195250,81157271,1.0956231585e-11,14343582,1265984,577566948
423500,2055338542,81155337,1.0955970495e-11,14280725,1265984,578832932
424000,2054290666,81251446,1.0968945209999999e-11,14681654,1266856,580099788
424500,2056095000,81171879,1.0958203664999998e-11,14818340,1267684,581367472
425000,2073176250,81173259,1.0958389965e-11,14863196,1266888,582634360
425500,2051620209,81173164,1.095837714e-11,14860123,1265984,583900344
426000,2071728542,81172593,1.0958300055e-11,14841538,1266400,585166744
426500,2049680750,81252317,1.0969062795e-11,14709974,1266416,586433160
427000,2049279208,81170686,1.0958042609999999e-11,14779576,1267220,587700380
427500,2056043875,81169574,1.095789249e-11,14743451,1266888,588967268
428000,2079651291,81171061,1.0958093235e-11,14791766,1265992,590233260
428500,2241112500,81254026,1.096929351e-11,14765504,1266872,591500132
429000,2069745125,81166253,1.0957444155e-11,14635507,1268472,592768604
429500,2056559000,81155280,1.09559628e-11,14278889,1266880,594035484
430000,2068620542,81154530,1.095586155e-11,14254520,1266888,595302372
430500,2052768292,81176269,1.0958796315000001e-11,14961030,1267652,596570024
431000,2055323334,81246554,1.0968284790000001e-11,14522679,1266880,597836904
431500,2051393583,81159335,1.0956510225e-11,14410681,1266416,599103320
432000,2071875875,81160886,1.0956719610000001e-11,14461088,1266864,600370184
432500,2059485958,81161605,1.0956816674999999e-11,14484457,1266860,601637044
433000,2051049875,81158466,1.095639291e-11,14382422,1266440,602903484
433500,2055653958,81243995,1.0967939325e-11,14439487,1265520,604169004
434000,2055661084,81159857,1.0956580694999999e-11,14427636,1265952,605434956
434500,2059812917,81160124,1.095661674e-11,14436322,1266416,606701372
435000,2059562958,81161204,1.095676254e-11,14471415,1266864,607968236
435500,2058719875,81249336,1.0968660359999999e-11,14613072,1267304,609235540
436000,2059861125,81141451,1.0954095885000001e-11,13829430,1266856,610502396
436500,2095733666,81141296,1.095407496e-11,13824388,1266392,611768788
437000,2064663417,81150430,1.095530805e-11,14121274,1266432,613035220
437500,2055701709,81156721,1.0956157335e-11,14325696,1265992,614301212
438000,2065020500,81244176,1.096796376e-11,14445376,1267328,615568540
438500,2066885125,81160631,1.0956685185e-11,14452804,1266432,616834972
439000,2052354708,81159586,1.095654411e-11,14418823,1267668,618102640
439500,2062062958,81158232,1.095636132e-11,14374832,1266888,619369528
440000,22020556459,176802153,2.3868290654999998e-11,14297465,-111927720,507441808
440500,2051258167,81162114,1.095688539e-11,14500989,1266880,508708688
441000,2061004625,81260718,1.097019693e-11,14362492,1266860,509975548
441500,2051273250,81158685,1.0956422475e-11,14389547,1266424,511241972
442000,2055942833,81159031,1.0956469185e-11,14400786,1265984,512507956
442500,2053302000,81156005,1.0956060675e-11,14302452,1266796,513774752
443000,2072288875,81156248,1.095609348e-11,14310351,1267684,515042436
443500,2057794167,81245551,1.0968149384999999e-11,13869582,1266440,516308876
444000,2104271959,81144638,1.095452613e-11,13933011,1265992,517574868
444500,2399345958,81158896,1.095645096e-11,14396387,1268556,518843424
445000,2038279625,81151973,1.0955516355e-11,14171407,1266424,520109848
445500,2063124250,81264711,1.0970735985e-11,14492284,1268988,521378836
446000,2057132042,81157463,1.0956257505e-11,14349833,1267328,522646164
446500,2058031458,81157299,1.0956235365000001e-11,14344502,1266872,523913036
447000,2072633375,81155964,1.095605514e-11,14301124,1267236,525180272
447500,2063428458,81158000,1.0956330000000001e-11,14367280,1266860,526447132
448000,2052255625,81258656,1.096991856e-11,14295490,1265968,527713100
448500,6478077375,81157389,1.0956247515e-11,14347443,1266880,528979980
449000,2056648042,81157291,1.0956234285e-11,14344239,1267692,530247672
449500,2073671667,81255556,1.0969500059999999e-11,14194753,1267228,531514900
450000,2052133041,81141531,1.0954106685000001e-11,13832034,1266432,532781332
450500,2051977750,81146778,1.095481503e-11,14002584,1267668,534049000
451000,2051001750,81156483,1.0956125204999999e-11,14317969,1266432,535315432
451500,2068025625,81258644,1.096991694e-11,14295103,1266440,536581872
452000,2066579292,81158105,1.0956344175e-11,14370678,1267676,537849548
452500,2059176875,81158166,1.095635241e-11,14372688,1266888,539116436
453000,2133199500,81159045,1.0956471075000001e-11,14401232,1266888,540383324
453500,2080333708,81157249,1.0956228615e-11,14342877,1266888,541650212
454000,2056493583,81258191,1.0969855785e-11,14280369,1266772,542916984
454500,2063202250,81157139,1.0956213765e-11,14339308,1266440,544183424
455000,2070505209,81157270,1.095623145e-11,14343566,1266440,545449864
455500,2070506625,81156413,1.0956115754999999e-11,14315687,1265992,546715856
456000,2068714500,81156521,1.0956130335e-11,14319215,1265968,547981824
456500,2058049250,81254407,1.0969344945e-11,14157386,1267212,549249036
457000,2050193000,81148889,1.0955100015000002e-11,14071176,1266408,550515444
457500,2075600500,81157617,1.0956278295e-11,14354841,1267280,551782724
458000,2053234042,81160093,1.0956612555e-11,14435322,1266864,553049588
458500,2051276875,81259460,1.09700271e-11,14321630,1265952,554315540
459000,2054397792,81145201,1.0954602135000001e-11,13951300,1266404,555581944
459500,2058946334,81148803,1.0955088405e-11,14068389,1266416,556848360
460000,2050608292,81159115,1.0956480525e-11,14403524,1265984,558114344
460500,2066082708,81158476,1.095639426e-11,14382753,1265068,559379412
461000,2167982625,81258160,1.09698516e-11,14279381,1266424,560645836
461500,2279423166,81153650,1.095574275e-11,14225910,1266856,561912692
462000,2068499542,81156818,1.095617043e-11,14328862,1266888,563179580
462500,2057849333,81157757,1.0956297194999999e-11,14359386,1266432,564446012
463000,2067951208,81159064,1.095647364e-11,14401856,1268132,565714144
463500,2077052542,81258077,1.0969840395e-11,14276670,1265960,566980104
464000,2062839209,81155270,1.0955961449999999e-11,14278551,1266416,568246520
464500,2051816041,81150378,1.0955301030000001e-11,14119579,1266760,569513280
465000,2051818542,81156932,1.095618582e-11,14332559,1268224,570781504
465500,2062303125,81250223,1.0968780104999999e-11,14021407,1266796,572048300
466000,2053205208,81145227,1.0954605645e-11,13952156,1266880,573315180
466500,2071263125,81157338,1.095624063e-11,14345776,1266432,574581612
467000,2052276750,81156178,1.095608403e-11,14308059,1266432,575848044
467500,2054911583,81155034,1.095592959e-11,14270886,1267228,577115272
468000,2062964833,81257862,1.0969811369999999e-11,14269690,1267308,578382580
468500,2052570709,81156327,1.0956104145e-11,14312900,1266888,579649468
469000,2072807708,81154515,1.0955859525e-11,14254019,1267644,580917112
469500,2052158250,81154333,1.0955834955e-11,14248108,1266432,582183544
470000,2071169625,81157984,1.095632784e-11,14366755,1266440,583449984
470500,2052500334,81258333,1.0969874955e-11,14284991,1266888,584716872
471000,2062537166,81154708,1.0955885579999999e-11,14260291,1265536,585982408
471500,2062478625,81153132,1.095567282e-11,14209077,1267212,587249620
472000,2163120542,81143768,1.095440868e-11,13904734,1267312,588516932
472500,2051052125,81149602,1.095519627e-11,14094365,1266864,589783796
473000,2050606834,81262052,1.097037702e-11,14405872,1266408,591050204
473500,2052270167,81159345,1.0956511575e-11,14411003,1266864,592317068
474000,2066005542,81156533,1.0956131955000001e-11,14319604,1265968,593583036
474500,2050890416,81156041,1.0956065535e-11,14303629,1266440,594849476
475000,2053873792,81258246,1.0969863209999999e-11,14282162,1267312,596116788
475500,2054078292,81157320,1.09562382e-11,14345194,1266432,597383220
476000,2052402625,81153414,1.095571089e-11,14218246,1265960,598649180
476500,2051784667,81155991,1.0956058784999999e-11,14301995,1266880,599916060
477000,2061352000,81158530,1.095640155e-11,14384496,1266404,601182464
477500,2058824417,81261388,1.097028738e-11,14384273,1268108,602450572
478000,2060294958,81155340,1.0955970899999999e-11,14280841,1265976,603716548
478500,2066046334,81155857,1.0956040695e-11,14297654,1265968,604982516
479000,2065165000,81155464,1.095598764e-11,14284865,1265960,606248476
479500,2052885708,81151565,1.0955461275e-11,14158157,1268132,607516608
480000,2056570125,81247876,1.0968463260000001e-11,13945142,1266764,608783372
480500,2050845167,81157636,1.0956280859999998e-11,14355446,1266888,610050260
481000,2060052584,81147155,1.0954865925e-11,14014811,1266440,611316700
481500,2121293125,81157376,1.095624576e-11,14346991,1267312,612584012
482000,2063526375,81257802,1.0969803269999999e-11,14267749,1267220,613851232
482500,2076481459,81157767,1.0956298545e-11,14359708,1267776,615119008
483000,2058258333,81157489,1.0956261015e-11,14350676,1266432,616385440
483500,2068020416,81156550,1.095613425e-11,14320148,1266796,617652236
484000,2054731791,81156177,1.0956083895e-11,14308040,1266432,618918668
484500,2055044416,81259790,1.0970071650000001e-11,14332335,1266440,620185108
485000,2069911584,81159021,1.0956467834999999e-11,14400484,1268124,621453232
485500,2063038542,81156784,1.095616584e-11,14327757,1266880,622720112
486000,2037725917,81171065,1.0958093774999999e-11,14791886,1268116,623988228
486500,2037258500,81154193,1.0955816055e-11,14243563,1266848,625255076
487000,2053051458,81258502,1.0969897769999999e-11,14290482,1267300,626522376
487500,2053895416,81153900,1.09557765e-11,14234019,1265512,627787888
488000,2052408250,81158723,1.0956427605000001e-11,14390782,1266416,629054304
488500,2049305542,81158985,1.0956462975e-11,14399303,1266416,630320720
489000,2054209417,81160024,1.0956603240000001e-11,14433051,1266848,631587568
489500,2159218625,81261571,1.0970312085e-11,14390232,1265956,632853524
490000,2120105625,81159347,1.0956511845e-11,14411055,1267304,634120828
490500,2069685458,81161137,1.0956753495e-11,14469252,1265960,635386788
491000,2061237542,81156185,1.0956084975e-11,14308288,1266268,636653056
491500,2054959667,81258760,1.09699326e-11,14298882,1265956,637919012
492000,2051191709,81156745,1.0956160575e-11,14326502,1265984,639184996
492500,2053691166,81158970,1.095646095e-11,14398800,1266404,640451400
493000,2053111125,81160403,1.0956654405e-11,14445395,1267664,641719064
493500,2059580750,81165079,1.0957285664999998e-11,14597343,1267652,642986716
494000,2061511667,81263581,1.0970583435000002e-11,14455559,1267320,644254036
494500,2058923000,81159801,1.0956573135000002e-11,14425824,1266440,645520476
495000,2059397125,81156442,1.095611967e-11,14316650,1267660,646788136
495500,2052930875,81159695,1.0956558825e-11,14422383,1266432,648054568
496000,2058763542,81138632,1.095371532e-11,13737809,1265536,649320104
496500,2054533459,81243692,1.096789842e-11,13809158,1266880,650586984
497000,2051932666,81141245,1.0954068075e-11,13822765,1267312,651854296
497500,2075198209,81142248,1.0954203479999999e-11,13855332,1267692,653121988
498000,2076889750,81140522,1.0953970469999999e-11,13799260,1266432,654388420
498500,2061227459,81243537,1.0967877495e-11,13804127,1267328,655655748
499000,2072585125,81141733,1.0954133954999998e-11,13838621,1267216,656922964
499500,2053268292,81139878,1.095388353e-11,13778333,1266440,658189404
500000,2057514042,81149959,1.0955244465000001e-11,14105951,1267336,659456740
500500,2064671416,81260183,1.0970124705e-11,14807967,1268584,660725324
501000,2067401250,81356782,1.098316557e-11,14604340,1267388,661992712
501500,2066842875,81262113,1.0970385255e-11,14870720,1267380,663260092
502000,2052272042,81273012,1.097185662e-11,15224934,1266916,664527008
502500,2053194375,81271029,1.0971588915000001e-11,15160485,1267288,665794296
503000,2064065041,81268060,1.09711881e-11,15063996,1266468,667060764
503500,2051428250,81373046,1.098536121e-11,15132909,1267356,668328120
504000,2054233250,81269310,1.097135685e-11,15104598,1267356,669595476
504500,2054632250,81270818,1.097156043e-11,15153630,1267356,670862832
505000,2051865750,81271371,1.0971635085e-11,15171579,1268256,672131088
505500,2054898875,81375090,1.0985637150000001e-11,15199352,1267356,673398444
506000,2066601833,81269464,1.0971377640000001e-11,15109625,1268152,674666596
506500,2066377416,81262760,1.0970472599999998e-11,14891747,1267296,675933892
507000,2068557916,81252095,1.0969032825e-11,14545120,1266036,677199928
507500,2060692709,81253160,1.09691766e-11,14579746,1266940,678466868
508000,2071370542,81357431,1.0983253185000002e-11,14625421,1268192,679735060
508500,2051791959,81267894,1.0971165690000001e-11,15058580,1267372,681002432
509000,2050727333,81267595,1.0971125325000001e-11,15048860,1266492,682268924
509500,2054524333,81267737,1.0971144495e-11,15053477,1267388,683536312
510000,2073906292,81268029,1.0971183915e-11,15062970,1267744,684804056
510500,2059460208,81379010,1.098616635e-11,15326753,1266916,686070972
511000,2053082583,81272571,1.0971797085000001e-11,15210585,1267812,687338784
511500,2068821125,81270756,1.097155206e-11,15151605,1267364,688606148
512000,2055722417,81271073,1.0971594855e-11,15161913,1266908,689873056
512500,2053447833,81269604,1.097139654e-11,15114155,1267364,691140420
513000,2050030625,81374021,1.0985492834999999e-11,15164616,1267812,692408232
513500,2059747125,81270644,1.0971536940000001e-11,15147951,1267348,693675580
514000,2059428625,81271369,1.0971634815e-11,15171545,1267712,694943292
514500,2102919792,81270468,1.097151318e-11,15142235,1266452,696209744
515000,2074212917,81391916,1.098790866e-11,15746181,1268244,697477988
515500,2052023583,81289059,1.0974022965e-11,15746447,1267812,698745800
516000,2056953375,81285839,1.0973588265e-11,15641806,1268600,700014400
516500,2052999042,81281730,1.097303355e-11,15508265,1267372,701281772
517000,2052987000,81284514,1.097340939e-11,15598736,1267380,702549152
517500,2051026541,81389047,1.0987521344999998e-11,15652951,1267744,703816896
518000,2061693500,81280673,1.0972890854999998e-11,15473921,1266940,705083836
518500,2047640542,81285192,1.097350092e-11,15620780,1266044,706349880
519000,2052285375,81283825,1.0973316375000001e-11,15576343,1266044,707615924
519500,2054317041,81285288,1.097351388e-11,15623887,1266940,708882864
520000,2058527625,81386821,1.0987220835000001e-11,15580608,1268192,710151056
520500,2062301375,81289678,1.0974106530000001e-11,15766583,1266568,711417624
521000,2059756958,81285732,1.097357382e-11,15638317,1267356,712684980
521500,2053761084,81272566,1.0971796410000001e-11,15210417,1268964,713953944
522000,2051514833,81282358,1.0973118330000001e-11,15528672,1266492,715220436
522500,2053645125,81388374,1.0987430489999999e-11,15631086,1267836,716488272
523000,2052000666,81270147,1.0971469845e-11,15131811,1266492,717754764
523500,2050902083,81272754,1.097182179e-11,15216544,1267736,719022500
524000,2056606333,81286068,1.0973619180000001e-11,15649255,1267372,720289872
524500,2258208625,81387302,1.098728577e-11,15596246,1266940,721556812
525000,2055249625,81285671,1.0973565585000001e-11,15636348,1267744,722824556
525500,2063804875,81288855,1.0973995424999999e-11,15739828,1268260,724092816
526000,2059819541,81286013,1.0973611755000001e-11,15647453,1267796,725360612
526500,2073253458,81285607,1.0973556945e-11,15634249,1267804,726628416
527000,2068298833,81388113,1.0987395255e-11,15622581,1267364,727895780
527500,2058465375,81285100,1.09734885e-11,15617805,1266020,729161800
528000,2054323792,81286708,1.0973705580000001e-11,15670035,1267356,730429156
528500,2070080417,81279933,1.0972790955e-11,15449855,1267248,731696404
529000,2058746250,81276320,1.0972303199999999e-11,15332440,1266916,732963320
529500,2062574000,81270522,1.0971520469999998e-11,15144002,1266916,734230236
530000,2051483041,81269932,1.097144082e-11,15124817,1266452,735496688
530500,2053371708,81274101,1.0972003635e-11,15260321,1266888,736763576
531000,2056863209,81289366,1.097406441e-11,15756439,1267804,738031380
531500,2061172083,81386043,1.0987115805e-11,15555319,1267296,739298676
532000,2053664792,81283113,1.0973220255e-11,15553212,1266932,740565608
532500,2060944583,81283995,1.0973339325e-11,15581856,1267820,741833428
533000,2221846875,81284691,1.0973433285e-11,15604494,1267712,743101140
533500,2055070500,81282923,1.0973194605000001e-11,15547045,1267836,744368976
534000,2065484250,81387323,1.0987288605e-11,15596922,1266492,745635468
534500,2046187375,81285109,1.0973489715e-11,15618072,1266932,746902400
535000,2051815583,81281160,1.09729566e-11,15489746,1267704,748170104
535500,2052747333,81282357,1.0973118195e-11,15528644,1267744,749437848
536000,2053389833,81375689,1.0985718015e-11,15218835,1267364,750705212
536500,2053021750,81284115,1.0973355525e-11,15585769,1268632,751973844
537000,2062887250,81286496,1.097367696e-11,15663154,1266912,753240756
537500,2055054791,81286477,1.0973674395e-11,15662536,1266940,754507696
538000,2064083834,81285730,1.097357355e-11,15638274,1268632,755776328
538500,2049113042,81388267,1.0987416045e-11,15627597,1266940,757043268
539000,2073185625,81286936,1.097373636e-11,15677469,1267380,758310648
539500,2055870792,81284755,1.0973441925e-11,15606578,1266476,759577124
540000,2052390916,81287456,1.097380656e-11,15694361,1268640,760845764
540500,2064506958,81287207,1.0973772944999999e-11,15686273,1267388,762113152
541000,27334506959,199026574,2.686858749e-11,15699767,-138192532,623920620
541500,2121012959,81283776,1.097330976e-11,15574762,1266916,625187536
542000,2067242750,81284831,1.0973452185e-11,15609046,1266908,626454444
542500,2054198875,81284969,1.0973470815e-11,15613527,1268160,627722604
543000,2054779084,81395762,1.0988427869999999e-11,15104776,1266916,628989520
543500,2061272541,81274646,1.097207721e-11,15278029,1266900,630256420
544000,2063250542,81286634,1.097369559e-11,15667628,1266916,631523336
544500,2057556250,81285052,1.097348202e-11,15616218,1267356,632790692
545000,2051203292,81286786,1.097371611e-11,15672572,1267804,634058496
545500,2062615167,81417703,1.0991389905e-11,15817842,1267364,635325860
546000,2053923459,81286475,1.0973674125e-11,15662485,1266468,636592328
546500,2062287959,81280741,1.0972900035e-11,15476117,1266492,637858820
547000,2071604583,81281273,1.0972971854999998e-11,15493422,1267744,639126564
547500,2052833834,81280963,1.0972930005e-11,15483345,1267388,640393952
548000,2050231375,81405799,1.0989782865000001e-11,15430956,1266492,641660444
548500,2058836125,81284439,1.0973399264999999e-11,15596309,1268168,642928612
549000,2056304417,81281032,1.0972939319999998e-11,15485593,1267388,644196000
549500,2062612417,81281237,1.0972966995e-11,15492235,1266940,645462940
550000,2125723958,81394701,1.0988284635000001e-11,15070295,1268100,646731040
550500,2060714375,81271130,1.097160255e-11,15163775,1266036,647997076
551000,2072348917,81277251,1.0972428885e-11,15362677,1266904,649263980
551500,2052011459,81283073,1.0973214855e-11,15551905,1269180,650533160
552000,2050480083,81282375,1.0973120625000001e-11,15529227,1266492,651799652
552500,2070491000,81410079,1.0990360665e-11,15570075,1267388,653067040
553000,2054211792,81282487,1.0973135745e-11,15532853,1267712,654334752
553500,8593519125,81409006,1.099021581e-11,15535213,1266916,655601668
554000,2051434834,81282596,1.0973150460000001e-11,15536400,1266916,656868584
554500,2074235500,81282552,1.0973144519999999e-11,15534974,1267388,658135972
555000,2050091167,81283598,1.097328573e-11,15568982,1266492,659402464
555500,2053557625,81285244,1.0973507940000001e-11,15622450,1268276,660670740
556000,2051979125,81398889,1.0988850014999999e-11,15206404,1267828,661938568
556500,2055000708,81270967,1.0971580545e-11,15158473,1266036,663204604
557000,2060486458,81283280,1.0973242800000001e-11,15558638,1266940,664471544
557500,2053936375,81272500,1.09717875e-11,15208296,1268100,665739644
558000,2243407958,81270558,1.097152533e-11,15145172,1266452,667006096
558500,2224352500,81272984,1.0971852839999999e-11,15224004,1268260,668274356
559000,2065172125,81274202,1.097201727e-11,15263600,1266924,669541280
559500,2054151209,81275014,1.0972126889999999e-11,15289981,1268160,670809440
560000,2033935417,81270762,1.0971552870000001e-11,15151793,1266932,672076372
560500,2051828875,81399206,1.098889281e-11,15216686,1266464,673342836
561000,2057312708,81269223,1.0971345105000001e-11,15101778,1267792,674610628
561500,2053300709,81278422,1.0972586969999999e-11,15400751,1266044,675876672
562000,2052381083,81286761,1.0973712735e-11,15671759,1267372,677144044
562500,2054044791,81285224,1.0973505240000001e-11,15621833,1267720,678411764
563000,2054538167,81412675,1.0990711125e-11,15654461,1266940,679678704
563500,2056834833,81285627,1.0973559644999999e-11,15634919,1266940,680945644
564000,2062995125,81285231,1.0973506185e-11,15622053,1267288,682212932
564500,2063070667,81285391,1.0973527785e-11,15627240,1267380,683480312
565000,2055705750,81283010,1.097320635e-11,15549862,1266044,684746356
565500,2058301291,81410143,1.0990369304999999e-11,15572160,1267388,686013744
566000,2062742708,81284012,1.097334162e-11,15582433,1266916,687280660
566500,2074003625,81284933,1.0973465955e-11,15612350,1267812,688548472
567000,2075053791,81285227,1.0973505644999998e-11,15621911,1267364,689815836
567500,2060994125,81409914,1.0990338389999999e-11,15564716,1267272,691083108
568000,2190264208,81271758,1.0971687329999999e-11,15184182,1266916,692350024
568500,2054326708,81269252,1.097134902e-11,15102734,1266916,693616940
569000,2053864458,81274472,1.097205372e-11,15272392,1267364,694884304
569500,2068192584,81285744,1.0973575440000002e-11,15638699,1266916,696151220
570000,2065925292,81401985,1.0989267975e-11,15307020,1267796,697419016
570500,2062595166,81287535,1.0973817225000001e-11,15696920,1266468,698685484
571000,2069814458,81286038,1.097361513e-11,15648280,1266044,699951528
571500,2070900417,81287301,1.0973785635e-11,15689309,1266900,701218428
572000,2068585375,81286062,1.097361837e-11,15649061,1266908,702485336
572500,2074884542,81410922,1.099047447e-11,15597466,1267356,703752692
573000,2063990417,81286665,1.0973699775e-11,15668648,1266908,705019600
573500,2068921042,81286202,1.0973637269999999e-11,15653609,1266916,706286516
574000,2064225542,81286411,1.0973665485e-11,15660380,1267356,707553872
574500,2054925291,81412824,1.099073124e-11,15659285,1267364,708821236
575000,2056908583,81287183,1.0973769705e-11,15685475,1266016,710087252
575500,2056710041,81289978,1.0974147029999999e-11,15776325,1267356,711354608
576000,2040292916,81277994,1.097252919e-11,15386837,1268192,712622800
576500,2037853959,81268630,1.097126505e-11,15082501,1268732,713891532
577000,2180321416,81397634,1.098868059e-11,15165612,1267828,715159360
577500,2294506083,81273285,1.0971893474999999e-11,15233788,1268612,716427972
578000,2059423208,81285550,1.097354925e-11,15632425,1267364,717695336
578500,2073911375,81283330,1.097324955e-11,15560260,1266908,718962244
579000,2051167250,81285894,1.097359569e-11,15643581,1266940,720229184
579500,2053186000,81288612,1.097396262e-11,15731944,1267344,721496528
580000,2055074458,81286364,1.097365914e-11,15658883,1267736,722764264
580500,2095096917,81287335,1.0973790225e-11,15690425,1266940,724031204
581000,2055433625,81284699,1.0973434365e-11,15604761,1267388,725298592
581500,2053061458,81413431,1.0990813184999999e-11,15679003,1267836,726566428
582000,2054661000,81284974,1.097347149e-11,15613686,1268176,727834604
582500,2055887125,81283788,1.097331138e-11,15575130,1266904,729101508
583000,2066932625,81277425,1.0972452375e-11,15368355,1268176,730369684
583500,2054637375,81271636,1.097167086e-11,15180206,1268632,731638316
584000,2055233542,81407366,1.098999441e-11,15481895,1267388,732905704
584500,2056257083,81283806,1.097331381e-11,15575722,1267372,734173076
585000,2060418750,81287742,1.097384517e-11,15703645,1267720,735440796
585500,2220818167,81285792,1.0973581920000001e-11,15640262,1268260,736709056
586000,2073810708,81283959,1.0973334464999999e-11,15580697,1266916,737975972
586500,2054349125,81409700,1.09903095e-11,15557748,1266020,739241992
587000,2055120000,81285291,1.0973514285e-11,15624004,1267804,740509796
587500,2057500416,81285419,1.0973531565e-11,15628141,1268260,741778056
588000,2052026417,81283767,1.0973308545e-11,15574458,1266908,743044964
588500,2053129833,81412052,1.0990627019999998e-11,15634187,1266908,744311872
589000,2041892292,81285728,1.097357328e-11,15638215,1267356,745579228
589500,2057229625,81283702,1.0973299770000001e-11,15572350,1266044,746845272
590000,2055044917,81286283,1.0973648205e-11,15656232,1267796,748113068
590500,2057609708,81283359,1.0973253464999999e-11,15561200,1267720,749380788
591000,2057006583,81400399,1.0989053864999998e-11,15255482,1266460,750647248
591500,2052995541,81282221,1.0973099835e-11,15524214,1266924,751914172
592000,2068607166,81273450,1.0971915750000001e-11,15239153,1267364,753181536
592500,2059142167,81267971,1.0971176085e-11,15061090,1267388,754448924
593000,2053556291,81268523,1.0971250605e-11,15079020,1267364,755716288
593500,2078717916,81400668,1.098909018e-11,15264216,1267356,756983644
594000,2282852959,81284833,1.0973452455e-11,15609116,1266916,758250560
594500,2063934709,81283066,1.097321391e-11,15551674,1266044,759516604
595000,2054337000,81284767,1.0973443545000001e-11,15606952,1266900,760783504
595500,2067532584,81414677,1.0990981394999999e-11,15719496,1266900,762050404
596000,2062466500,81281715,1.0973031525000001e-11,15507761,1267388,763317792
596500,2054556584,81280434,1.0972858589999998e-11,15466147,1266460,764584252
597000,2068664250,81279940,1.09727919e-11,15450079,1266924,765851176
597500,2055851042,81284071,1.0973349585e-11,15584346,1267828,767119004
598000,2062487584,81411308,1.0990526580000002e-11,15610025,1268144,768387148
598500,2062821167,81277634,1.097248059e-11,15375137,1267744,769654892
599000,2060635000,81268770,1.097128395e-11,15087066,1266476,770921368
599500,2059195167,81264056,1.0970647559999999e-11,14933848,1267388,772188756
600000,2054181083,81265906,1.097089731e-11,14993983,1266924,773455680
600500,2064314750,81400510,1.098906885e-11,15259081,1268252,774723932
601000,2062001583,81284093,1.0973352555e-11,15585065,1267372,775991304
601500,2048460500,81284456,1.0973401559999999e-11,15596840,1267820,777259124
602000,2066146625,81281728,1.0973033279999999e-11,15508195,1268168,778527292
602500,2170217792,81407323,1.0989988605e-11,15480519,1267364,779794656
603000,2064994917,81283955,1.0973333925e-11,15580560,1267800,781062456
603500,2063267917,81285477,1.0973539395e-11,15630037,1267380,782329836
604000,2061653375,81283233,1.0973236455e-11,15557096,1268632,783598468
604500,2053194292,81283167,1.0973227545e-11,15554970,1267364,784865832
605000,2060858792,81410582,1.099042857e-11,15586429,1266484,786132316
605500,2056719458,81285916,1.097359866e-11,15644301,1266940,787399256
606000,2056846500,81277785,1.0972500975e-11,15380060,1268192,788667448
606500,2052821167,81268505,1.0971248175e-11,15078449,1266932,789934380
607000,2061108750,81281702,1.097302977e-11,15507361,1268176,791202556
607500,2055444542,81410644,1.099043694e-11,15588432,1266908,792469464
608000,2069954041,81284228,1.097337078e-11,15589450,1267380,793736844
608500,2057198916,81284625,1.0973424375e-11,15602344,1268608,795005452
609000,2050935833,81281735,1.0973034225000001e-11,15508415,1266468,796271920
609500,2053197666,81281597,1.0973015595000001e-11,15503940,1267820,797539740
610000,2054148833,81410400,1.0990404e-11,15580499,1266940,798806680
610500,2070664000,81287268,1.097378118e-11,15688235,1267280,800073960
611000,2112621125,81285762,1.0973577869999999e-11,15639313,1267356,801341316
611500,2055683042,81284296,1.097337996e-11,15591653,1266916,802608232
612000,2051159334,81409527,1.0990286145000001e-11,15552151,1267356,803875588
612500,2054587292,81285553,1.0973549655e-11,15632516,1268252,805143840
613000,2063702625,81280917,1.0972923795e-11,15481836,1267704,806411544
613500,2057592750,81272952,1.097184852e-11,15222975,1266916,807678460
614000,2056771209,81270724,1.097154774e-11,15150556,1267804,808946264
614500,2056057875,81396984,1.098859284e-11,15144486,1267804,810214068
615000,2059959625,81272142,1.0971739169999999e-11,15196658,1266460,811480528
615500,2060466000,81287501,1.0973812635e-11,15695822,1266908,812747436
616000,2052035416,81282376,1.0973120759999998e-11,15529270,1266904,814014340
616500,2058392458,81283731,1.0973303685e-11,15573296,1267352,815281692
617000,2054187542,81408999,1.0990214865e-11,15534982,1266932,816548624
617500,2055613541,81284642,1.0973426669999999e-11,15602911,1267836,817816460
618000,2053597458,81284983,1.0973472705000001e-11,15613984,1267380,819083840
618500,2068539333,81285151,1.0973495385e-11,15619450,1267812,820351652
619000,2073659042,81410230,1.0990381050000001e-11,15574988,1266940,821618592
619500,2077165166,81282575,1.0973147624999999e-11,15535708,1266468,822885060
620000,2051434958,81281935,1.0973061225e-11,15514919,1266484,824151544
620500,2053850166,81289257,1.0974049694999999e-11,15752888,1267828,825419372
621000,2100639958,81280988,1.097293338e-11,15484140,1267364,826686736
621500,2255081250,81401245,1.0989168075000001e-11,15282971,1267600,827954336
622000,2048099167,81260470,1.097016345e-11,14817297,1267380,829221716
622500,2057605375,81258378,1.096988103e-11,14749310,1266932,830488648
623000,2067123625,81259588,1.0970044379999999e-11,14788649,1267272,831755920
623500,2053406791,81258432,1.096988832e-11,14751071,1267836,833023756
624000,2053492167,81383056,1.098671256e-11,14691823,1266476,834290232
624500,2073205084,81260178,1.097012403e-11,14807831,1267796,835558028
625000,2055562167,81261161,1.0970256735e-11,14839774,1267360,836825388
625500,2062707041,81262612,1.097045262e-11,14886915,1267356,838092744
626000,2053064459,81380865,1.0986416775000001e-11,14620608,1266932,839359676
626500,2059709500,81257986,1.0969828110000001e-11,14736568,1268252,840627928
627000,2069332291,81271167,1.0971607545000001e-11,15164961,1267388,841895316
627500,2054586542,81269027,1.0971318645e-11,15095425,1266460,843161776
628000,2054779875,81268748,1.097128098e-11,15086364,1267364,844429140
628500,2056975667,81395352,1.0988372519999999e-11,15091442,1266044,845695184
629000,2058545167,81271107,1.0971599444999998e-11,15163006,1266468,846961652
629500,2289739458,81271522,1.0971655469999999e-11,15176492,1266940,848228592
630000,2336364875,81270867,1.0971567045e-11,15155198,1266916,849495508
630500,2065747791,81273388,1.0971907379999999e-11,15237143,1266012,850761520
631000,2062492541,81397269,1.0988631314999998e-11,15153753,1266468,852027988
631500,2056462166,81270994,1.0971584189999999e-11,15159347,1266932,853294920
632000,2056293167,81273076,1.097186526e-11,15227020,1267728,854562648
632500,2053671459,81272353,1.0971767655e-11,15203500,1267804,855830452
633000,2057233625,81390689,1.0987743015000001e-11,14939907,1268604,857099056
633500,2063083291,81254704,1.096938504e-11,14629896,1267364,858366420
634000,2052524292,81253000,1.0969155e-11,14574551,1267388,859633808
634500,2069059333,81266802,1.097101827e-11,15023112,1266484,860900292
635000,2053617334,81271467,1.0971648045e-11,15174723,1267728,862168020
635500,2049905750,81397686,1.0988687609999999e-11,15167291,1266492,863434512
636000,2049643375,81270821,1.0971560834999999e-11,15153709,1266940,864701452
636500,2059127292,81271687,1.0971677745000001e-11,15181859,1266940,865968392
637000,2048118083,81271428,1.0971642780000001e-11,15173445,1268608,867237000
637500,2063204208,81267270,1.097108145e-11,15038315,1266896,868503896
638000,2120478334,81398437,1.0988788995e-11,15191719,1268284,869772180
638500,2222712208,81270026,1.097145351e-11,15127869,1268184,871040364
639000,2062567667,81266700,1.09710045e-11,15019790,1266044,872306408
639500,2051587541,81269253,1.0971349155e-11,15102764,1266924,873573332
640000,2054434334,81389958,1.098764433e-11,14916149,1267296,874840628
640500,2055249625,81260073,1.0970109855e-11,14804417,1267836,876108464
641000,2057018792,81255239,1.0969457264999998e-11,14647287,1266916,877375380
641500,2039302750,81253263,1.0969190505e-11,14583075,1267388,878642768
642000,2049145334,81254225,1.0969320375e-11,14614364,1268168,879910936
642500,2053699792,81395843,1.0988438804999999e-11,15107406,1266484,881177420
643000,2052933709,81270376,1.097150076e-11,15139274,1267836,882445256
643500,2056661208,81269188,1.097134038e-11,15100641,1269080,883714336
644000,2055423084,81269180,1.0971339300000001e-11,15100393,1267388,884981724
644500,2056514959,81268280,1.09712178e-11,15071123,1266940,886248664
645000,2060853833,81392867,1.0988037045e-11,15010679,1267272,887515936
645500,2061596542,81273375,1.0971905625000001e-11,15236712,1266908,888782844
646000,2058112875,81269064,1.097132364e-11,15096600,1266916,890049760
646500,2147730125,81268245,1.0971213075e-11,15069996,1267348,891317108
647000,2257385625,81397145,1.0988614575e-11,15149718,1268152,892585260
647500,2082828625,81267071,1.0971054584999999e-11,15031841,1266916,893852176
648000,2070573542,81270676,1.097154126e-11,15149009,1267804,895119980
648500,2050030583,81278548,1.097260398e-11,15404855,1266900,896386880
649000,2053074250,81284541,1.0973413035000002e-11,15599626,1267364,897654244
649500,2052624541,81411483,1.0990550205e-11,15615690,1267352,898921596
650000,2052599250,81286303,1.0973650905e-11,15656874,1267372,900188968
650500,2070770375,81283414,1.097326089e-11,15562996,1266940,901455908
651000,2057017834,81285122,1.0973491469999999e-11,15618509,1267356,902723264
651500,2050147958,81284510,1.097340885e-11,15598600,1267828,903991092
652000,2061448833,81411813,1.0990594754999998e-11,15626431,1267296,905258388
652500,2068204583,81281985,1.0973067975e-11,15516563,1266932,906525320
653000,2072537334,81285850,1.097358975e-11,15642153,1267356,907792676
653500,2055674584,81285396,1.097352846e-11,15627398,1266932,909059608
654000,2052805250,81284946,1.097346771e-11,15612774,1267736,910327344
654500,2069154708,81400567,1.0989076545e-11,15260925,1268168,911595512
655000,2058717500,81264381,1.0970691435e-11,14944418,1266940,912862452
655500,2080819417,81274393,1.0972043054999999e-11,15269816,1267744,914130196
656000,2064823416,81255597,1.0969505595e-11,14658937,1266912,915397108
656500,2063600042,81394591,1.0988269784999999e-11,15066702,1267364,916664472
657000,2054721834,81270348,1.097149698e-11,15138329,1267780,917932252
657500,2055861834,81268237,1.0971211995e-11,15069726,1266456,919198708
658000,2063908917,81271008,1.097158608e-11,15159807,1266908,920465616
658500,2056404250,81272642,1.0971806669999999e-11,15212894,1267364,921732980
659000,2053512041,81397194,1.098862119e-11,15151314,1267812,923000792
659500,2066518875,81269486,1.097138061e-11,15110325,1267356,924268148
660000,2060858458,81269115,1.0971330524999999e-11,15098264,1266460,925534608
660500,2054651084,81274470,1.097205345e-11,15272316,1268252,926802860
661000,2057572458,81269910,1.097143785e-11,15124100,1267820,928070680
661500,2057971583,81394683,1.0988282205000001e-11,15069713,1267356,929338036
662000,2060059500,81269318,1.0971357930000001e-11,15104878,1268260,930606296
662500,2059864833,81269843,1.0971428805000001e-11,15121924,1268168,931874464
663000,2056563000,81268972,1.0971311219999999e-11,15093614,1266904,933141368
663500,2072321500,81272632,1.097180532e-11,15212582,1267388,934408756
664000,2366019750,81279697,1.0972759095e-11,15442184,1266900,935675656
664500,2061366416,81285184,1.0973499840000001e-11,15620532,1267364,936943020
665000,33403190917,226041456,3.051559656e-11,15697174,-170020600,766922420
665500,2055353917,81289054,1.097402229e-11,15746292,1267364,768189784
666000,2058508292,81283442,1.097326467e-11,15563888,1267388,769457172
666500,2050720833,81283786,1.097331111e-11,15575069,1266932,770724104
667000,2050644959,81440229,1.0994430914999999e-11,15610080,1268700,771992804
667500,2065793625,81282782,1.097317557e-11,15542461,1267364,773260168
668000,2054084333,81286331,1.0973654685e-11,15657785,1267388,774527556
668500,2057836750,81286496,1.097367696e-11,15663139,1267280,775794836
669000,2053527917,81286548,1.0973683980000001e-11,15664859,1267356,777062192
669500,2062811291,81439985,1.0994397974999999e-11,15602137,1266460,778328652
670000,2068613750,81285707,1.0973570444999998e-11,15637505,1266908,779595560
670500,2065284958,81280080,1.09728108e-11,15454620,1268632,780864192
671000,2052950542,81271272,1.097162172e-11,15168382,1267836,782132028
671500,2053535500,81280289,1.0972839014999999e-11,15461430,1267812,783399840
672000,2050505042,81442079,1.0994680665000001e-11,15670201,1267288,784667128
672500,2052923208,81288383,1.0973931705e-11,15724491,1267828,785934956
673000,2065325333,81287579,1.0973823165e-11,15698363,1267388,787202344
673500,2119888000,81287800,1.0973853e-11,15705553,1266476,788468820
674000,2061774167,81441356,1.0994583060000001e-11,15646725,1268184,789737004
674500,2054499292,81287864,1.097386164e-11,15707622,1267812,791004816
675000,2066216125,81288655,1.0973968425000001e-11,15733329,1267388,792272204
675500,2063110125,81290128,1.097416728e-11,15781188,1268160,793540364
676000,2053392291,81286809,1.0973719215000001e-11,15673336,1267388,794807752
676500,2055893917,81440110,1.0994414850000001e-11,15606214,1266940,796074692
677000,2063202292,81284089,1.0973352015e-11,15584939,1266492,797341184
677500,2066409125,81271532,1.097165682e-11,15176830,1268996,798610180
678000,2054256791,81269108,1.097132958e-11,15098029,1266484,799876664
678500,2061644917,81269356,1.0971363060000002e-11,15106116,1267388,801144052
679000,2057251084,81443333,1.0994849955e-11,15710974,1268632,802412684
679500,2050724583,81287852,1.0973860019999998e-11,15707215,1267828,803680512
680000,2070985417,81283675,1.0973296124999999e-11,15571463,1266476,804946988
680500,2053846791,81291424,1.0974342239999998e-11,15823305,1269064,806216052
681000,2147410334,81285924,1.097359974e-11,15644582,1267820,807483872
681500,2108372750,81286102,1.097362377e-11,15650355,1266916,808750788
682000,2499911875,81286720,1.09737072e-11,15670425,1267372,810018160
682500,11080622208,81458911,1.0996952985e-11,15712311,1266900,811285060
683000,2059160042,81287581,1.0973823435e-11,15698418,1267356,812552416
683500,2058045833,81285479,1.0973539665e-11,15630090,1266468,813818884
684000,2060266250,81446630,1.0995295049999999e-11,15818125,1267348,815086232
684500,2061820500,81292985,1.0974552975e-11,15874048,1267720,816353952
685000,2060045750,81284210,1.097336835e-11,15588864,1266932,817620884
685500,2053908667,81289722,1.097411247e-11,15767997,1266932,818887816
686000,2053351958,81275099,1.0972138365e-11,15292746,1268252,820156068
686500,2054966250,81428743,1.0992880305e-11,15236797,1266940,821423008
687000,2071753291,81275433,1.0972183454999999e-11,15303609,1268184,822691192
687500,2054565375,81272186,1.097174511e-11,15198091,1265568,823956760
688000,2050822834,81275395,1.0972178324999998e-11,15302366,1266940,825223700
688500,2056794875,81274174,1.0972013490000001e-11,15262703,1266460,826490160
689000,2050924292,81431028,1.099318878e-11,15311058,1267836,827757996
689500,2064567209,81275090,1.097213715e-11,15292449,1268616,829026612
690000,2372047458,81275865,1.0972241775e-11,15317664,1266916,830293528
690500,2067753458,81280345,1.0972846575e-11,15463257,1267836,831561364
691000,2061299166,81424862,1.099235637e-11,15110652,1266940,832828304
691500,2050844458,81280255,1.0972834425e-11,15460326,1267388,834095692
692000,2051114334,81285364,1.097352414e-11,15626378,1268640,835364332
692500,2052207084,81285384,1.097352684e-11,15626999,1267380,836631712
693000,2052353125,81288458,1.097394183e-11,15726928,1269528,837901240
693500,2070339791,81440126,1.0994417009999999e-11,15606751,1266468,839167708
694000,2060803834,81286548,1.0973683980000001e-11,15664845,1268252,840435960
694500,2054187250,81285845,1.0973589074999999e-11,15641986,1266924,841702884
695000,2063673084,81288143,1.0973899305e-11,15716677,1269080,842971964
695500,2061749208,81444244,1.099497294e-11,15740562,1267388,844239352
696000,2059451416,81287110,1.0973759850000001e-11,15683125,1268144,845507496
696500,2050381958,81280045,1.0972806074999999e-11,15453498,1267236,846774732
697000,2056708500,81267874,1.0971162990000002e-11,15057938,1266908,848041640
697500,2062151666,81270643,1.0971536804999999e-11,15147926,1266932,849308572
698000,2065101750,81428182,1.099280457e-11,15218541,1267364,850575936
698500,2216196833,81282692,1.097316342e-11,15539521,1266916,851842852
699000,2063685917,81290448,1.097421048e-11,15791601,1268256,853111108
699500,2053110708,81284096,1.097335296e-11,15585171,1267364,854378472
700000,2055678875,81287294,1.0973784690000001e-11,15689105,1266916,855645388
700500,2052525166,81440764,1.099450314e-11,15627464,1267360,856912748
701000,2057240583,81283403,1.0973259405000001e-11,15562619,1267356,858180104
701500,2058595208,81279777,1.0972769895e-11,15444780,1266492,859446596
702000,2057323667,81283547,1.0973278845e-11,15567321,1268192,860714788
702500,2052666875,81281459,1.0972996965e-11,15499461,1266932,861981720
703000,2073535375,81283236,1.097323686e-11,15557189,1266036,863247756
703500,2050070042,81283864,1.097332164e-11,15577598,1267372,864515128
704000,2059931625,81281455,1.0972996425e-11,15499309,1268964,865784092
704500,2068361667,81267300,1.09710855e-11,15039279,1267388,867051480
705000,2063244583,81421681,1.0991926935e-11,15007259,1266492,868317972
705500,2070580792,81272170,1.097174295e-11,15197561,1267380,869585352
706000,2049927416,81285896,1.097359596e-11,15643671,1266940,870852292
706500,2053129542,81282326,1.097311401e-11,15527631,1267812,872120104
707000,2358631250,81283700,1.0973299499999999e-11,15572286,1266908,873387012
707500,2068985958,81440237,1.0994431995e-11,15610343,1266932,874653944
708000,2065125042,81281567,1.0973011544999999e-11,15502950,1266900,875920844
708500,2066167917,81284112,1.097335512e-11,15585676,1267364,877188208
709000,2061218333,81285411,1.0973530485e-11,15627880,1266940,878455148
709500,2049547500,81283971,1.0973336085e-11,15581088,1268268,879723416
710000,2050273625,81437964,1.099412514e-11,15536463,1266464,880989880
710500,2049754333,81289643,1.0974101805e-11,15765445,1267356,882257236
711000,2052484542,81283759,1.0973307465e-11,15574212,1267364,883524600
711500,2053871875,81286026,1.0973613509999999e-11,15647870,1266940,884791540
712000,2057684542,81440544,1.099447344e-11,15620309,1266940,886058480
712500,2065044125,81273633,1.0971940455e-11,15245109,1268520,887327000
713000,2072775375,81282685,1.0973162475e-11,15539304,1265996,888592996
713500,2061269750,81284511,1.0973408985e-11,15598631,1266932,889859928
714000,2060802333,81287250,1.0973778749999999e-11,15687662,1266484,891126412
714500,2054850042,81442136,1.0994688359999999e-11,15672061,1266940,892393352
715000,2058738125,81286036,1.097361486e-11,15648225,1267744,893661096
715500,2052204125,81288079,1.0973890665e-11,15714602,1266468,894927564
716000,2078504209,81284508,1.0973408580000001e-11,15598535,1267340,896194904
716500,2059276584,81283740,1.0973304899999998e-11,15573598,1266044,897460948
717000,2346027791,81438239,1.0994162264999999e-11,15545421,1268184,898729132
717500,2459801458,81282966,1.0973200410000001e-11,15548430,1266940,899996072
718000,2279933375,81284464,1.097340264e-11,15597102,1266940,901263012
718500,2066498834,81285708,1.097357058e-11,15637550,1269088,902532100
719000,2059263708,81434446,1.0993650209999999e-11,15422153,1267708,903799808
719500,2054338625,81276290,1.097229915e-11,15331467,1266476,905066284
720000,2052552500,81286000,1.097361e-11,15647024,1268612,906334896
720500,2052405000,81277695,1.0972488825e-11,15377108,1266908,907601804
721000,2048899291,81286944,1.097373744e-11,15677716,1268252,908870056
721500,2051615209,81439243,1.0994297805e-11,15578050,1266940,910136996
722000,2069433125,81286487,1.0973675745000001e-11,15662869,1267364,911404360
722500,2053091083,81286163,1.0973632005e-11,15652339,1267388,912671748
723000,2052275917,81286414,1.097366589e-11,15660486,1267380,913939128
723500,2068963333,81440558,1.099447533e-11,15620778,1267372,915206500
724000,2051695250,81285565,1.0973551275000001e-11,15632904,1267364,916473864
724500,2067324875,81284886,1.097345961e-11,15610823,1267836,917741700
725000,2060724958,81285942,1.097360217e-11,15645144,1267804,919009504
725500,2054165917,81288162,1.097390187e-11,15717287,1268260,920277764
726000,2147727542,81440425,1.0994457375e-11,15616451,1267388,921545152
726500,2421894334,81286121,1.0973626335e-11,15650967,1266940,922812092
727000,2052409125,81277582,1.0972473570000001e-11,15373444,1268996,924081088
727500,2064856084,81268783,1.0971285705e-11,15087481,1266460,925347548
728000,2052567334,81439780,1.09943703e-11,15595484,1267380,926614928
728500,2051878291,81284540,1.09734129e-11,15599595,1266940,927881868
729000,2051393833,81285744,1.0973575440000002e-11,15638718,1268176,929150044
729500,2050817958,81285886,1.0973594609999999e-11,15643330,1268284,930418328
730000,2054750542,81286733,1.0973708955e-11,15670869,1266008,931684336
730500,2067936917,81443096,1.099481796e-11,15703252,1266932,932951268
731000,2055788750,81286073,1.0973619855000001e-11,15649397,1266460,934217728
731500,2062167334,81286461,1.0973672235e-11,15662030,1267804,935485532
732000,2066896542,81284159,1.0973361465000002e-11,15587209,1266460,936751992
732500,2055718042,81284788,1.097344638e-11,15607633,1266884,938018876
733000,2060930500,81285856,1.097359056e-11,15642350,1266900,939285776
733500,2052758833,81286969,1.0973740815e-11,15678524,1267796,940553572
734000,2063980166,81284816,1.097345016e-11,15608549,1266460,941820032
734500,2408444791,81285696,1.097356896e-11,15637159,1268608,943088640
735000,2366409917,81427020,1.09926477e-11,15180803,1266908,944355548
735500,2062227917,81277645,1.0972482075000001e-11,15375494,1266900,945622448
736000,2054046250,81271312,1.097162712e-11,15169672,1267332,946889780
736500,2056703417,81275547,1.0972198845e-11,15307316,1267364,948157144
737000,2062402417,81441912,1.0994658119999999e-11,15664794,1266908,949424052
737500,2055824333,81287500,1.09738125e-11,15695801,1266020,950690072
738000,2051106625,81286608,1.0973692080000001e-11,15666787,1266460,951956532
738500,2063314250,81285068,1.0973484180000001e-11,15616760,1266468,953223000
739000,2055330375,81287863,1.0973861505e-11,15707566,1267356,954490356
739500,2061519125,81441744,1.099463544e-11,15659319,1267380,955757736
740000,2056068208,81287819,1.0973855565000001e-11,15706138,1267812,957025548
740500,2054164417,81289697,1.0974109095e-11,15767188,1267796,958293344
741000,2052924083,81281386,1.097298711e-11,15497079,1266492,959559836
741500,2052560250,81282289,1.0973109015e-11,15526428,1267372,960827208
742000,2055208208,81436147,1.0993879845e-11,15477421,1267364,962094572
742500,2080669958,81284919,1.0973464065e-11,15611894,1267836,963362408
743000,2250003875,81275892,1.097224542e-11,15318538,1267736,964630144
743500,2492463750,81266868,1.097102718e-11,15025246,1267712,965897856
744000,2059588834,81421344,1.099188144e-11,14996330,1267372,967165228
744500,2056888875,81275785,1.0972230975e-11,15315051,1266896,968432124
745000,2059207833,81287028,1.0973748779999998e-11,15680442,1267380,969699504
745500,2053406334,81292452,1.097448102e-11,15856721,1269056,970968560
746000,2052292875,81284975,1.0973471625e-11,15613726,1267820,972236380
746500,2054066583,81439794,1.099437219e-11,15595932,1267388,973503768
747000,2065297958,81285498,1.097354223e-11,15630734,1266924,974770692
747500,2054441208,81284844,1.0973453940000001e-11,15609472,1267696,976038388
748000,2052063959,81282947,1.0973197845e-11,15547825,1266464,977304852
748500,2065564625,81282506,1.097313831e-11,15533494,1266444,978571296
749000,2055893834,81438646,1.0994217209999998e-11,15558634,1266456,979837752
749500,2055784125,81286828,1.0973721779999999e-11,15673962,1267388,981105140
750000,2069880250,81288294,1.0973919689999998e-11,15721600,1268168,982373308
750500,2051990083,81280968,1.097293068e-11,15483485,1267836,983641144
751000,2052741625,81272462,1.097178237e-11,15207051,1266916,984908060
751500,2117512166,81271091,1.0971597285e-11,15162495,1268608,986176668
752000,2568432833,81286329,1.0973654415000001e-11,15657719,1266940,987443608
752500,2059702625,81286020,1.09736127e-11,15647676,1267388,988710996
753000,2054227958,81286666,1.0973699910000002e-11,15668681,1267272,989978268
753500,2057532709,81441769,1.0994638815e-11,15660136,1266932,991245200
754000,2057000958,81285830,1.097358705e-11,15641525,1267836,992513036
754500,2065151917,81288996,1.097401446e-11,15744397,1268608,993781644
755000,2062202375,81286193,1.0973636055e-11,15653310,1267828,995049472
755500,2054072959,81445443,1.0995134805e-11,15779536,1266036,996315508
756000,2055179583,81285552,1.097354952e-11,15632494,1266892,997582400
756500,2053646875,81284820,1.0973450699999999e-11,15608684,1270216,998852616
757000,2063052334,81270504,1.0971518040000001e-11,15143409,1267380,1000119996
757500,2064986042,81269533,1.0971386955e-11,15111871,1266940,1001386936
758000,2082544250,81424073,1.0992249855e-11,15085003,1269064,1002656000
758500,2057364625,81268372,1.0971230219999999e-11,15074111,1266484,1003922484
759000,2053097167,81269907,1.0971437445e-11,15124004,1266932,1005189416
759500,2128817125,81272378,1.097177103e-11,15204314,1268168,1006457584
760000,2289804958,81426200,1.0992537e-11,15154133,1267364,1007724948
760500,2052097125,81269765,1.0971418275e-11,15119410,1266940,1008991888
761000,2065828000,81272847,1.0971834345e-11,15219557,1267348,1010259236
761500,2066141125,81271693,1.0971678555e-11,15182071,1267736,1011526972
762000,2062009708,81285442,1.097353467e-11,15628898,1266940,1012793912
762500,2054339041,81442976,1.099480176e-11,15699354,1268724,1014062636
763000,2065540667,81286231,1.0973641185000001e-11,15654536,1268192,1015330828
763500,2050350708,81285506,1.0973543309999998e-11,15630983,1267388,1016598216
764000,2051056041,81288489,1.0973946015e-11,15727945,1268284,1017866500
764500,2061837833,81286446,1.0973670209999999e-11,15661540,1267736,1019134236
765000,2061332583,81441102,1.099454877e-11,15638460,1266476,1020400712
765500,2056256292,81285886,1.0973594609999999e-11,15643335,1266932,1021667644
766000,2058430625,81287275,1.0973782125e-11,15688482,1267356,1022935000
766500,2067224375,81282416,1.0973126159999998e-11,15530546,1267712,1024202712
767000,2069287625,81281718,1.097303193e-11,15507867,1267744,1025470456
767500,2053466083,81423294,1.099214469e-11,15059706,1266932,1026737388
768000,2106765542,81268420,1.09712367e-11,15075684,1266940,1028004328
768500,2286935875,81281483,1.0973000205e-11,15500223,1267744,1029272072
769000,2066494167,81274117,1.0972005795e-11,15260838,1267388,1030539460
769500,2059545375,81441102,1.099454877e-11,15638462,1266036,1031805496
770000,2061939541,81285175,1.0973498625e-11,15620233,1268192,1033073688
770500,2054011875,81286911,1.0973732985e-11,15676639,1266128,1034339816
771000,2055531708,81286609,1.0973692214999999e-11,15666817,1267356,1035607172
771500,2055292791,81282190,1.0973095649999999e-11,15523197,1267716,1036874888
772000,2052173875,81440249,1.0994433614999999e-11,15610724,1267380,1038142268
772500,2050069750,81284620,1.09734237e-11,15602193,1266484,1039408752
773000,2071987042,81282886,1.097318961e-11,15545838,1266492,1040675244
773500,2055323208,81284433,1.0973398455e-11,15596104,1268192,1041943436
774000,2071264666,81434771,1.0993694085e-11,15432712,1267744,1043211180
774500,2050279458,81269792,1.097142192e-11,15120281,1267380,1044478560
775000,2051678000,81269380,1.09713663e-11,15106885,1268192,1045746752
775500,2068746875,81273544,1.0971928439999999e-11,15242212,1267364,1047014116
776000,2060845875,81286073,1.0973619855000001e-11,15649419,1267364,1048281480
776500,2211550750,81440561,1.0994475735e-11,15620883,1268632,1049550112
777000,2281532250,81282313,1.0973112254999999e-11,15527211,1267380,1050817492
777500,2053939125,81284964,1.0973470139999999e-11,15613367,1267388,1052084880
778000,2064533792,81285148,1.097349498e-11,15619356,1268640,1053353520
778500,2057049916,81439424,1.099432224e-11,15583916,1266940,1054620460
779000,2054103125,81283621,1.0973288835000001e-11,15569726,1267828,1055888288
779500,2059725625,81282473,1.0973133855e-11,15532424,1266808,1057155096
780000,2052961458,81283693,1.0973298555e-11,15572073,1267380,1058422476
780500,2051650500,81288800,1.0973988e-11,15738036,1268616,1059691092
781000,2069920167,81427525,1.0992715875e-11,15197213,1266908,1060958000
781500,2052862083,81283384,1.097325684e-11,15561996,1268632,1062226632
782000,2065245333,81283970,1.097333595e-11,15581069,1266940,1063493572
782500,2053298959,81286373,1.0973660355e-11,15659163,1266476,1064760048
783000,2053425584,81285772,1.097357922e-11,15639644,1267728,1066027776
783500,2064338833,81439116,1.099428066e-11,15573908,1266940,1067294716
784000,2069028708,81285313,1.0973517255e-11,15624720,1266492,1068561208
784500,2074053084,81286605,1.0973691675e-11,15666713,1269072,1069830280
785000,2389228959,81283354,1.097325279e-11,15561050,1266924,1071097204
785500,2398230500,81441786,1.099464111e-11,15660703,1265688,1072362892
786000,2072777583,81287460,1.09738071e-11,15694478,1266468,1073629360
786500,2057022833,81284036,1.097334486e-11,15583220,1268600,1074897960
787000,2064692000,81283772,1.097330922e-11,15574607,1266940,1076164900
787500,2071867709,81286932,1.0973735820000001e-11,15677340,1268640,1077433540
788000,2052180792,81457338,1.0996740629999999e-11,16166131,1268616,1078702156
788500,2054492792,81300602,1.097558127e-11,16121589,1266932,1079969088
789000,2051327625,81303869,1.0976022315e-11,16227778,1267388,1081236476
789500,2057667291,81299847,1.0975479344999999e-11,16097071,1267744,1082504220
790000,2056542542,81456583,1.0996638705e-11,16141586,1266476,1083770696
790500,2064623500,81301599,1.0975715865e-11,16154010,1266932,1085037628
791000,2056995959,81301413,1.0975690755e-11,16147947,1266908,1086304536
791500,2051488833,81299751,1.0975466385000001e-11,16093935,1268160,1087572696
792000,2060609042,81297390,1.0975147649999999e-11,16017204,1266492,1088839188
792500,2050869750,81456063,1.0996568505e-11,16124705,1267820,1090107008
793000,2194278250,81303037,1.0975909994999998e-11,16200745,1267388,1091374396
793500,2158544625,81301094,1.097564769e-11,16137590,1267720,1092642116
794000,2234274916,81300038,1.097550513e-11,16103257,1269064,1093911180
794500,2068131625,81295098,1.097483823e-11,15942734,1267388,1095178568
795000,2054902166,81457985,1.0996827975000001e-11,16187138,1267720,1096446288
795500,2064399167,81293958,1.097468433e-11,15905673,1266492,1097712780
796000,2069132333,81290535,1.0974222224999999e-11,15794411,1266916,1098979696
796500,2054393667,81295046,1.097483121e-11,15941038,1267736,1100247432
797000,2056044542,81450614,1.099583289e-11,15947583,1266492,1101513924
797500,2068404500,81297516,1.0975164659999999e-11,16021312,1267836,1102781760
798000,2061904458,81297964,1.097522514e-11,16035868,1266484,1104048244
798500,2050824083,81298695,1.0975323825e-11,16059627,1267264,1105315508
799000,2052052958,81295086,1.097483661e-11,15942317,1266908,1106582416
799500,2050183833,81452139,1.0996038765e-11,15997165,1266940,1107849356
800000,2050702666,81298969,1.0975360815e-11,16068536,1267828,1109117184
800500,2051835792,81298201,1.0975257135000001e-11,16043579,1268532,1110385716
801000,2051333417,81283322,1.0973248470000001e-11,15559992,1268724,1111654440
801500,2078020708,81293279,1.0974592665e-11,15883599,1266908,1112921348
802000,2224652458,81455235,1.0996456724999998e-11,16097783,1267348,1114188696
802500,2313283375,81300385,1.0975551974999999e-11,16114536,1266932,1115455628
803000,2052613958,81300110,1.0975514850000001e-11,16105601,1266932,1116722560
803500,2053725625,81299605,1.0975446675000001e-11,16089190,1267804,1117990364
804000,2052286417,81455954,1.0996553789999999e-11,16121135,1266452,1119256816
804500,2052215667,81298395,1.0975283324999999e-11,16049859,1266916,1120523732
805000,2051729208,81301153,1.0975655654999998e-11,16139517,1267812,1121791544
805500,2050756292,81304587,1.0976119245e-11,16251099,1267836,1123059380
806000,2059390875,81450154,1.099577079e-11,15932641,1266492,1124325872
806500,2065089708,81296385,1.0975011975000001e-11,15984562,1266908,1125592780
807000,2056055000,81298113,1.0975245255e-11,16040698,1266900,1126859680
807500,2063805625,81297828,1.097520678e-11,16031443,1266460,1128126140
808000,2070942625,81298790,1.097533665e-11,16062701,1267812,1129393952
808500,2051129584,81452407,1.0996074944999999e-11,16005879,1266904,1130660856
809000,2051094000,81298000,1.0975230000000001e-11,16037046,1267736,1131928592
809500,2052820750,81283537,1.0973277494999999e-11,15566983,1268252,1133196844
810000,2051551375,81290442,1.0974209669999998e-11,15791398,1267356,1134464200
810500,2051874125,81303260,1.0975940100000001e-11,16207993,1267380,1135731580
811000,2051968000,81445596,1.099515546e-11,15784523,1267364,1136998944
811500,2066193708,81299765,1.0975468275e-11,16094401,1266908,1138265852
812000,2053886666,81300941,1.0975627035e-11,16132619,1267388,1139533240
812500,2285222833,81300197,1.0975526595e-11,16108436,1267264,1140800504
813000,2058436042,81455883,1.0996544205000001e-11,16118850,1267348,1142067852
813500,2051691542,81300265,1.0975535775e-11,16110652,1267820,1143335672
814000,2062632792,81298305,1.0975271175e-11,16046942,1267364,1144603036
814500,2050419708,81300099,1.0975513365e-11,16105255,1267364,1145870400
815000,2063311292,81300372,1.097555022e-11,16114131,1266464,1147136864
815500,2063665167,81458183,1.0996854705000001e-11,16193586,1267380,1148404244
816000,2068814917,81298632,1.097531532e-11,16057574,1266940,1149671184
816500,2054700125,81298247,1.0975263345e-11,16045051,1266916,1150938100
817000,40851981250,259133927,3.4983080145000004e-11,15803384,-208713124,942224976
817500,2057171167,81475401,1.0999179135e-11,15602052,1266932,943491908
818000,2058707083,81284291,1.0973379285e-11,15591495,1267364,944759272
818500,2059961833,81283764,1.097330814e-11,15574367,1266900,946026172
819000,2070751958,81294534,1.0974762089999998e-11,15924395,1267380,947293552
819500,2054285666,81301386,1.097568711e-11,16147068,1266492,948560044
820000,2052925041,81300415,1.0975556025e-11,16115526,1267388,949827432
820500,2083768250,81305789,1.0976281515e-11,16290176,1268168,951095600
821000,2101806542,81299228,1.0975395780000001e-11,16076965,1266932,952362532
821500,2068599209,81300318,1.097554293e-11,16112364,1267380,953629912
822000,2059317625,81490836,1.100126286e-11,16103704,1266044,954895956
822500,2079118542,81298643,1.0975316805000001e-11,16057928,1266468,956162424
823000,2057975250,81300031,1.0975504185e-11,16103049,1266008,957428432
823500,2055480000,81301092,1.0975647420000001e-11,16137506,1267360,958695792
824000,2053328541,81299170,1.097538795e-11,16075063,1267360,959963152
824500,2056774916,81494055,1.1001697425e-11,16208314,1267364,961230516
825000,2068982125,81304600,1.0976120999999999e-11,16251524,1268168,962498684
825500,2053379208,81301427,1.0975692644999999e-11,16148399,1266028,963764712
826000,2066477833,81287488,1.0973810879999999e-11,15695401,1267364,965032076
826500,2056448750,81290281,1.0974187934999998e-11,15786172,1267380,966299456
827000,2071238417,81288174,1.0973903489999999e-11,15717699,1266940,967566396
827500,2059604542,81291452,1.097434602e-11,15824214,1268632,968835028
828000,2055571292,81291176,1.097430876e-11,15815256,1267808,970102836
828500,2056149166,81291032,1.097428932e-11,15810583,1267820,971370656
829000,2057835291,81480072,1.099980972e-11,15753858,1266924,972637580
829500,2325807458,81288665,1.0973969775e-11,15733657,1266916,973904496
830000,2312872292,81290222,1.097417997e-11,15784261,1266932,975171428
830500,2061685250,81292481,1.0974484935e-11,15857668,1269064,976440492
831000,2054879000,81475255,1.0999159425000001e-11,15597301,1267372,977707864
831500,2067670083,81288142,1.097389917e-11,15716653,1267380,978975244
832000,2065125750,81300738,1.097559963e-11,16126031,1266908,980242152
832500,2064800792,81298459,1.0975291965e-11,16051965,1267388,981509540
833000,2056927875,81300700,1.09755945e-11,16124786,1266900,982776440
833500,2055531166,81492780,1.1001525299999999e-11,16166874,1267804,984044244
834000,2063529875,81302635,1.0975855724999998e-11,16187660,1267356,985311600
834500,2057070542,81301548,1.0975708979999999e-11,16152349,1266460,986578060
835000,2053772666,81303846,1.097601921e-11,16227034,1267804,987845864
835500,2052926916,81300935,1.0975626225e-11,16132434,1267348,989113212
836000,2092386291,81491813,1.1001394755e-11,16135452,1266912,990380124
836500,2055407791,81298214,1.0975258889999999e-11,16043977,1266908,991647032
837000,2051975042,81301186,1.0975660109999999e-11,16140576,1266940,992913972
837500,2060492333,81300067,1.0975509045000001e-11,16104207,1266452,994180424
838000,2805652000,81489765,1.1001118275e-11,16068887,1266908,995447332
838500,2310720709,81292216,1.097444916e-11,15849073,1268156,996715488
839000,14092878292,81530489,1.1006616014999999e-11,15532273,1266932,997982420
839500,2059709250,81283479,1.0973269664999999e-11,15565102,1266460,999248880
840000,2055661042,81294664,1.097477964e-11,15928635,1267812,1000516692
840500,2056890625,81493081,1.1001565934999999e-11,16176647,1266476,1001783168
841000,2054114250,81292607,1.0974501945000001e-11,15861771,1267364,1003050532
841500,2054597000,81300882,1.097561907e-11,16130711,1266916,1004317448
842000,2065885292,81303222,1.097593497e-11,16206756,1269064,1005586512
842500,2060056041,81299446,1.097542521e-11,16084041,1266916,1006853428
843000,2063494125,81490791,1.1001256785e-11,16102220,1267388,1008120816
843500,2060294167,81297987,1.0975228245e-11,16036603,1266476,1009387292
844000,2071412667,81299755,1.0975466925e-11,16094059,1267836,1010655128
844500,2059072875,81299819,1.0975475564999999e-11,16096145,1266492,1011921620
845000,2053065750,81300661,1.0975589235e-11,16123525,1267828,1013189448
845500,2053555084,81494619,1.1001773565e-11,16226630,1268276,1014457724
846000,2131134333,81296290,1.0974999149999999e-11,15981453,1267380,1015725104
846500,2257518709,81288672,1.097397072e-11,15733889,1266824,1016991928
847000,2378326000,81282545,1.0973143575e-11,15534738,1267812,1018259740
847500,2075830292,81473928,1.099898028e-11,15554186,1268260,1019528000
848000,2065489542,81284118,1.097335593e-11,15585863,1267364,1020795364
848500,2069907041,81283694,1.097329869e-11,15572096,1266932,1022062296
849000,2059921791,81294209,1.0974718215000001e-11,15913827,1267812,1023330108
849500,2056689375,81300838,1.097561313e-11,16129278,1267720,1024597828
850000,2059224750,81299898,1.097548623e-11,16098712,1266908,1025864736
850500,2074225625,81297056,1.0975102559999999e-11,16006353,1266484,1027131220
851000,2064123042,81298357,1.0975278194999999e-11,16048650,1267836,1028399056
851500,2066624333,81299381,1.0975416435e-11,16081906,1266916,1029665972
852000,2064398917,81488921,1.1001004335e-11,16041436,1266932,1030932904
852500,2054586083,81296974,1.097509149e-11,16003684,1267736,1032200640
853000,2064350208,81296435,1.0975018725000002e-11,15986160,1266484,1033467124
853500,2066593209,81297126,1.0975112010000001e-11,16008618,1266492,1034733616
854000,2070328542,81290793,1.0974257055e-11,15802813,1268632,1036002248
854500,2069961334,81473435,1.0998913725e-11,15538147,1267364,1037269612
855000,2078953708,81289692,1.097410842e-11,15767029,1266916,1038536528
855500,2161872042,81303517,1.0975974794999999e-11,16216337,1266932,1039803460
856000,2215318250,81298749,1.0975331115e-11,16061370,1266932,1041070392
856500,2321015208,81488661,1.1000969235e-11,16033003,1266940,1042337332
857000,2061805791,81300367,1.0975549544999999e-11,16113967,1267828,1043605160
857500,2055185333,81302801,1.0975878135e-11,16193065,1267720,1044872880
858000,2057886541,81295215,1.0974854024999999e-11,15946519,1266908,1046139788
858500,2051918000,81295762,1.0974927870000001e-11,15964294,1266492,1047406280
859000,2053961875,81487487,1.1000810744999999e-11,15994837,1267352,1048673632
859500,2054290208,81298784,1.0975335839999998e-11,16062500,1266940,1049940572
860000,2054705750,81301423,1.0975692105e-11,16148280,1267388,1051207960
860500,2057297500,81301875,1.0975753125e-11,16162966,1267264,1052475224
861000,2058798458,81299332,1.097540982e-11,16080345,1267344,1053742568
861500,2060828667,81481515,1.1000004525000001e-11,15800765,1267296,1055009864
862000,2052549166,81297500,1.0975162500000001e-11,16020792,1268192,1056278056
862500,2068104958,81300777,1.0975604895e-11,16127300,1266932,1057544988
863000,2066348000,81294544,1.0974763439999999e-11,15924698,1266484,1058811472
863500,2065899458,81476014,1.0999261890000002e-11,15621991,1268276,1060079748
864000,2070428000,81296572,1.097503722e-11,15990621,1266492,1061346240
864500,2067179166,81299625,1.0975449375000001e-11,16089836,1268192,1062614432
865000,2055556042,81302025,1.0975773375e-11,16167846,1267836,1063882268
865500,2061098667,81303450,1.097596575e-11,16214150,1266484,1065148752
866000,2636531875,81489265,1.1001050774999999e-11,16052653,1266012,1066414764
866500,2221378500,81302955,1.0975898924999999e-11,16198072,1268284,1067683048
867000,2056645584,81299502,1.097543277e-11,16085859,1266020,1068949068
867500,2066000583,81300970,1.0975630949999999e-11,16133552,1266916,1070215984
868000,2063251125,81492780,1.1001525299999999e-11,16166864,1267356,1071483340
868500,2056972791,81302392,1.0975822919999999e-11,16179759,1266896,1072750236
869000,2057183292,81294564,1.0974766139999999e-11,15925367,1267264,1074017500
869500,2076096083,81288678,1.0973971530000001e-11,15734064,1267356,1075284856
870000,2065874500,81285453,1.0973536155e-11,15629254,1266916,1076551772
870500,2051734583,81480367,1.0999849545000001e-11,15763460,1267360,1077819132
871000,2057027000,81301666,1.097572491e-11,16156172,1267364,1079086496
871500,2065826916,81301435,1.0975693725e-11,16148656,1266044,1080352540
872000,2072407334,81302226,1.097580051e-11,16174373,1266036,1081618576
872500,2067412334,81491818,1.1001395429999999e-11,16135624,1267364,1082885940
873000,2068009584,81299420,1.0975421699999999e-11,16083186,1266020,1084151960
873500,2054691958,81301666,1.097572491e-11,16156187,1266912,1085418872
874000,2064556333,81302801,1.0975878135e-11,16193068,1266908,1086685780
874500,2508094625,81299594,1.097544519e-11,16088834,1266916,1087952696
875000,2169413958,81493623,1.1001639105000002e-11,16194284,1267380,1089220076
875500,2066303750,81304244,1.097607294e-11,16239977,1267812,1090487888
876000,2097741125,81299420,1.0975421699999999e-11,16083190,1266016,1091753904
876500,2054414709,81301995,1.0975769325e-11,16166866,1267836,1093021740
877000,2059133625,81491054,1.1001292289999999e-11,16110780,1267388,1094289128
877500,2055972833,81295750,1.0974926249999999e-11,15963905,1268192,1095557320
878000,2062730416,81284450,1.097340075e-11,15596674,1266916,1096824236
878500,2064492750,81292019,1.0974422565e-11,15842638,1266908,1098091144
879000,2057489167,81301901,1.0975756635e-11,16163825,1267364,1099358508
879500,2073058625,81490726,1.100124801e-11,16100128,1267364,1100625872
880000,2058185333,81302101,1.0975783635e-11,16170317,1267348,1101893220
880500,2048747959,81305657,1.0976263694999999e-11,16285900,1267812,1103161032
881000,2054617666,81298353,1.0975277655e-11,16048519,1267388,1104428420
881500,2053171416,81301401,1.0975689135e-11,16147575,1266932,1105695352
882000,2055795375,81492725,1.1001517875e-11,16165086,1268184,1106963536
882500,2221542875,81297553,1.0975169655e-11,16022497,1266484,1108230020
883000,3068772500,81298231,1.0975261185e-11,16044555,1267380,1109497400
883500,2360534125,81490222,1.100117997e-11,16083727,1266916,1110764316
884000,2061761958,81299353,1.0975412655e-11,16081020,1267372,1112031688
884500,2087460792,81300942,1.0975627169999999e-11,16132639,1266840,1113298528
885000,2056095333,81294904,1.097481204e-11,15936399,1267264,1114565792
885500,2051964417,81287104,1.097375904e-11,15682908,1268284,1115834076
886000,2054421709,81473249,1.0998888615e-11,15532127,1266916,1117100992
886500,2066058708,81281528,1.097300628e-11,15501684,1266484,1118367476
887000,2052331209,81293154,1.097457579e-11,15879546,1268168,1119635644
887500,2071116167,81296086,1.097497161e-11,15974844,1267380,1120903024
888000,2055000666,81296889,1.0975080015e-11,16000928,1267380,1122170404
888500,2052865917,81489470,1.100107845e-11,16059292,1267728,1123438132
889000,2050362000,81296358,1.0975008329999999e-11,15983662,1266476,1124704608
889500,2071629875,81297273,1.0975131855e-11,16013408,1266932,1125971540
890000,2058858042,81298288,1.097526888e-11,16046411,1267388,1127238928
890500,2054051875,81302608,1.097585208e-11,16186788,1266908,1128505836
891000,2056761916,81489606,1.100109681e-11,16063720,1266460,1129772296
891500,2615166708,81298291,1.0975269285e-11,16046477,1267356,1131039652
892000,2197422625,81301863,1.0975751505e-11,16162571,1266908,1132306560
892500,2073560959,81494120,1.10017062e-11,16210407,1268964,1133575524
893000,2058453000,81278775,1.0972634625e-11,15412229,1267804,1134843328
893500,2067471875,81279473,1.0972728855e-11,15434901,1266468,1136109796
894000,2053928291,81282201,1.0973097135e-11,15523575,1266468,1137376264
894500,2082307417,81285088,1.097348688e-11,15617398,1266916,1138643180
895000,2067086833,81475435,1.0999183725e-11,15603159,1267348,1139910528
895500,2066047167,81284383,1.0973391704999998e-11,15594479,1266020,1141176548
896000,2052048916,81271952,1.097171352e-11,15190469,1267348,1142443896
896500,2066578583,81271961,1.0971714735e-11,15190756,1267820,1143711716
897000,2066903333,81270389,1.0971502515e-11,15139684,1266460,1144978176
897500,2059013625,81462320,1.09974132e-11,15176917,1266468,1146244644
898000,2066481000,81271268,1.097162118e-11,15168247,1266916,1147511560
898500,2058720000,81273566,1.097193141e-11,15242936,1268260,1148779820
899000,2055204541,81273237,1.0971886995000001e-11,15232253,1266940,1150046760
899500,2839373041,81463680,1.0997596800000001e-11,15221119,1266908,1151313668
900000,2496506209,81275659,1.0972213964999998e-11,15310956,1267812,1152581480
900500,2240660250,81276458,1.0972321829999999e-11,15336927,1266476,1153847956
901000,2063647334,81284916,1.097346366e-11,15611794,1266940,1155114896
901500,2060004500,81477470,1.099945845e-11,15669288,1266924,1156381820
902000,2052807709,81282794,1.097317719e-11,15542839,1266468,1157648288
902500,2070581208,81273574,1.097193249e-11,15243184,1268524,1158916812
903000,2058674583,81286092,1.097362242e-11,15650033,1268276,1160185088
903500,2051744833,81285516,1.097354466e-11,15631318,1266044,1161451132
904000,2057567250,81477441,1.0999454534999998e-11,15668374,1266932,1162718064
904500,2068210000,81286908,1.0973732579999999e-11,15676539,1267744,1163985808
905000,2063148750,81285973,1.0973606355e-11,15646169,1266916,1165252724
905500,2070874208,81289060,1.0974023100000001e-11,15746479,1267828,1166520552
906000,2055320917,81284824,1.0973451240000001e-11,15608815,1267356,1167787908
906500,2055454584,81475092,1.0999137420000001e-11,15592019,1267364,1169055272
907000,2055646458,81282172,1.097309322e-11,15522638,1266908,1170322180
907500,2053733750,81284593,1.0973420055e-11,15601302,1266940,1171589120
908000,2062499375,81282838,1.0973183129999998e-11,15544274,1266020,1172855140
908500,2105179542,81283305,1.0973246175000001e-11,15559463,1266468,1174121608
909000,3172724167,81283334,1.097325009e-11,15560383,1267352,1175388960
909500,2060814666,81285306,1.097351631e-11,15624491,1267720,1176656680
910000,2066693542,81288775,1.0973984625e-11,15737224,1266460,1177923140
910500,2065049291,81304072,1.0976049719999999e-11,16234357,1266940,1179190080
911000,2064440667,81476889,1.0999380015e-11,15650397,1267388,1180457468
911500,2063649916,81283669,1.0973295315e-11,15571266,1267388,1181724856
912000,2066878667,81286077,1.0973620395e-11,15649526,1267796,1182992652
912500,2057626208,81298114,1.097524539e-11,16040731,1266932,1184259584
913000,2040482458,81492879,1.1001538665e-11,16170078,1267288,1185526872
913500,2054391875,81300601,1.0975581135e-11,16121576,1266492,1186793364
914000,2052444500,81299888,1.097548488e-11,16098408,1267800,1188061164
914500,2052909167,81300916,1.097562366e-11,16131789,1266916,1189328080
915000,2053806917,81302765,1.0975873275e-11,16191894,1267372,1190595452
915500,2057102583,81495186,1.1001850109999999e-11,16245067,1266932,1191862384
916000,2057834291,81300775,1.0975604625e-11,16127210,1267380,1193129764
916500,2062692708,81300663,1.0975589504999999e-11,16123571,1267836,1194397600
917000,2061872875,81301408,1.097569008e-11,16147785,1268092,1195665692
917500,2302635584,81283420,1.0973261700000001e-11,15563176,1266492,1196932184
918000,2295888458,81285619,1.0973558564999999e-11,15634641,1267372,1198199556
918500,2065740250,81286838,1.097372313e-11,15674283,1266484,1199466040
919000,2052100791,81297352,1.097514252e-11,16015979,1266940,1200732980
919500,2059888166,81301368,1.097568468e-11,16146502,1266028,1201999008
920000,2065322042,81491893,1.1001405555e-11,16138059,1267744,1203266752
920500,2068257292,81306567,1.0976386544999999e-11,16315471,1267808,1204534560
921000,2054962417,81303448,1.097596548e-11,16214108,1266908,1205801468
921500,2056800708,81301312,1.097567712e-11,16144670,1268244,1207069712
922000,2065633500,81302270,1.097580645e-11,16175821,1267364,1208337076
922500,2050385666,81491708,1.100138058e-11,16132043,1266916,1209603992
923000,2055424625,81300615,1.0975583025000001e-11,16122017,1267356,1210871348
923500,2052860709,81299137,1.0975383495e-11,16073987,1266020,1212137368
924000,2064001125,81299869,1.0975482315000001e-11,16097785,1266908,1213404276
924500,2054188625,81493704,1.1001650039999999e-11,16196910,1267360,1214671636
925000,2051048250,81294930,1.097481555e-11,15937253,1266376,1215938012
925500,2244677333,81286320,1.09736532e-11,15657430,1266460,1217204472
926000,2483131458,81289295,1.0974054825e-11,15754116,1267820,1218472292
926500,2272105625,81489625,1.1001099375e-11,16064322,1267356,1219739648
927000,2065672208,81297611,1.0975177484999999e-11,16024386,1266912,1221006560
927500,2053516125,81300521,1.0975570335e-11,16118975,1267796,1222274356
928000,2054270583,81302228,1.0975800779999999e-11,16174461,1267388,1223541744
928500,2052798084,81302075,1.0975780124999998e-11,16169480,1269052,1224810796
929000,2054839791,81492777,1.1001524894999999e-11,16166786,1267388,1226078184
929500,2070897334,81299786,1.0975471110000001e-11,16095094,1266932,1227345116
930000,2057198333,81298918,1.097535393e-11,16066869,1267348,1228612464
930500,2051032500,81304872,1.097615772e-11,16260388,1267828,1229880292
931000,2057889417,81298925,1.0975354874999998e-11,16067096,1266940,1231147232
931500,2059760875,81490885,1.1001269475e-11,16105281,1267828,1232415060
932000,2068001250,81302003,1.0975770405e-11,16167125,1267388,1233682448
932500,2074800459,81293928,1.0974680280000001e-11,15904678,1268532,1234950980
933000,2075765625,81284542,1.0973413169999999e-11,15599665,1267380,1236218360
933500,2054009417,81286852,1.0973725020000001e-11,15674738,1267828,1237486188
934000,2059124500,81475687,1.0999217745e-11,15611340,1268184,1238754372
934500,2499777792,81299724,1.0975462739999999e-11,16093065,1267348,1240021720
935000,2251011000,81299559,1.0975440465e-11,16087687,1267388,1241289108
935500,2061605750,81305688,1.097626788e-11,16286899,1267744,1242556852
936000,2073188083,81490365,1.1001199275000001e-11,16088405,1267340,1243824192
936500,2054782083,81295276,1.097486226e-11,15948524,1266940,1245091132
937000,2056172791,81297628,1.097517978e-11,16024963,1268640,1246359772
937500,2054527750,81295804,1.097493354e-11,15965655,1267372,1247627144
938000,2051732875,81295460,1.09748871e-11,15954468,1266940,1248894084
