Size,Time,Cycles,Price,Instructions,HeapSize,TotalHeapSize
5000,2058925875,21121931,2.8514606850000005e-12,106414770,765348,766460
10000,2070948875,23052670,3.1121104500000004e-12,121509210,785580,1552040
15000,2063150125,23921593,3.2294150550000004e-12,126966068,784828,2336868
20000,2060443083,24762050,3.3428767500000005e-12,131462877,786708,3123576
25000,2054453208,25679280,3.4667028e-12,138419900,786472,3910048
30000,2058266292,26294069,3.5496993150000004e-12,135655903,784876,4694924
35000,2063161375,27009465,3.646277775e-12,136095236,786332,5481256
40000,2058935875,27866632,3.76199532e-12,141145412,786236,6267492
45000,2049893500,28525720,3.8509722000000006e-12,139768725,785580,7053072
50000,2059490583,29274406,3.952044810000001e-12,141250191,785344,7838416
55000,2057065000,31056341,4.1926060350000005e-12,151353556,786096,8624512
60000,2062634959,31710692,4.280943420000001e-12,149829696,785296,9409808
65000,2049646417,32482459,4.385131965e-12,152113202,785720,10195528
70000,2060241875,33145406,4.47462981e-12,150811040,788444,10983972
75000,2063985458,33847309,4.569386715e-12,150744961,785532,11769504
80000,2053354292,34584643,4.668926805e-12,151990255,785768,12555272
85000,2060579166,35351907,4.772507445000001e-12,154134573,785252,13340524
90000,2056802916,23534449,3.1771506150000003e-12,157614348,6449900,19790424
95000,2040564667,36800315,4.968042525000001e-12,155656442,-4881044,14909380
100000,2054732292,23537291,3.1775342850000006e-12,157706743,6452700,21362080
105000,2045611750,38202835,5.157382725000001e-12,155709457,-4885064,16477016
110000,2059667709,23534734,3.1771890900000007e-12,157623632,6442824,22919840
115000,2051603834,39645355,5.3521229250000005e-12,156963964,-4869832,18050008
120000,2060353125,23489215,3.171044025e-12,156002821,6408824,24458832
125000,3278833250,41070189,5.544475515000001e-12,157687194,-4838136,19620696
130000,2061017792,23476187,3.1692852450000004e-12,155720843,6412232,26032928
135000,2061773375,42479669,5.7347553150000005e-12,157883500,-4840040,21192888
140000,2058315417,23488492,3.17094642e-12,156120769,6425200,27618088
145000,3278725542,43876276,5.9232972600000005e-12,157476809,-4851600,22766488
150000,2060899250,23515390,3.1745776500000002e-12,156994940,6439812,29206300
155000,3284388250,45206941,6.102937035000001e-12,155290976,-4868700,24337600
160000,2046473167,23540013,3.1779017550000005e-12,157616527,6446076,30783676
165000,3262645209,46670858,6.30056583e-12,157242350,-4873040,25910636
170000,2061967042,23512606,3.1742018100000003e-12,156904473,6432604,32343240
175000,2064402375,23532410,3.1768753500000006e-12,157548101,6454160,38797400
180000,3276348792,48877154,6.598415790000001e-12,160325176,-10529276,28268124
185000,2056424167,23655940,3.1935519e-12,161562830,6544112,34812236
190000,2058516041,23647365,3.1923942750000003e-12,161284138,6529200,41341436
195000,3280980000,50955073,6.878934855e-12,159694332,-10716904,30624532
200000,2059633750,23685477,3.1975393950000003e-12,162522759,6563108,37187640
205000,2060123833,23606420,3.1868667000000002e-12,159720121,6500912,43688552
210000,3257297333,53183763,7.179808005000001e-12,163690152,-10704836,32983716
215000,2059323917,23662703,3.1944649050000003e-12,161782632,6534868,39518584
220000,2063548583,23700607,3.199581945e-12,163014483,6559648,46078232
225000,3276570541,55249391,7.458667785000001e-12,162136866,-10735760,35342472
230000,2060478208,23645498,3.1921422300000005e-12,161223460,6538864,41881336
235000,2050065833,23707513,3.2005142550000003e-12,163238956,6572752,48454088
240000,3257515500,57303412,7.735960620000001e-12,160801086,-10756944,37697144
245000,2060396125,23695614,3.19890789e-12,162576889,6565776,44262920
250000,2059057333,23703251,3.199938885e-12,163100422,6563568,50826488
255000,3280128750,59452514,8.02608939e-12,162264128,-10772936,40053552
260000,2059874417,23705044,3.2001809400000003e-12,163158710,6578392,46631944
265000,2043953292,23684906,3.19746231e-12,162214704,6542316,53174260
270000,2060830125,23677548,3.1964689800000005e-12,162265071,6542148,59716408
275000,3264271375,62218372,8.399480220000001e-12,160940461,-16518944,43197464
280000,2069380875,23682507,3.1971384450000007e-12,162426229,6569100,49766564
285000,2056947792,23635829,3.1908369150000003e-12,160909226,6527096,56293660
290000,2044459458,23706541,3.200383035e-12,162882385,6570284,62863944
295000,4728844209,65173241,8.798387535e-12,165789309,-16524256,46339688
300000,2064787208,23852349,3.2200671150000003e-12,167946121,6812448,53152136
305000,2071255042,24012895,3.241740825e-12,172819924,7151552,60303688
310000,2068297375,23988632,3.23846532e-12,172375308,7137772,67441460
315000,3263909709,68249418,9.21367143e-12,174577838,-17959316,49482144
320000,2052059750,24030466,3.24411291e-12,173734898,7165056,56647200
325000,2063907584,24079326,3.2507090100000007e-12,175322865,7203976,63851176
330000,2073167125,24020803,3.2428084050000005e-12,173052501,7160620,71011796
335000,4747163542,70974071,9.581499585000001e-12,171979118,-18389308,52622488
340000,2068234542,24041199,3.2455618650000007e-12,174083717,7189936,59812424
345000,2067528625,23995391,3.2393777850000003e-12,172207009,7147780,66960204
350000,2067258792,24049973,3.2467463550000002e-12,174368894,7192224,74152428
355000,4719563542,73843420,9.968861700000001e-12,174040852,-18387248,55765180
360000,2068236625,23937292,3.2315344200000004e-12,170706768,7097932,62863112
365000,2068607542,24066378,3.2489610300000004e-12,174495314,7186760,70049872
370000,2073291250,24023159,3.2431264650000004e-12,173497451,7155412,77205284
375000,4731682375,76703103,1.0354918905000001e-11,175732928,-18294588,58910696
380000,2060299917,24013961,3.2418847350000003e-12,173198490,7163312,66074008
385000,2060985709,24044593,3.2460200550000002e-12,173768920,7175708,73249716
390000,2050217167,24039655,3.245353425e-12,174033569,7186408,80436124
395000,2059035250,24009202,3.2412422700000003e-12,173043830,7165688,87601812
400000,4710038875,80182401,1.0824624135e-11,174837664,-24763876,62837936
405000,2063129542,24005338,3.24072063e-12,172918243,7162932,70000868
410000,2066378709,24061262,3.2482703700000002e-12,174735773,7192000,77192868
415000,2075778333,23917672,3.2288857200000005e-12,170069124,7085228,84278096
420000,2068944000,23902739,3.2268697650000006e-12,169583803,7055392,91333488
425000,4745272792,83491274,1.1271321990000001e-11,167878570,-24566200,66767288
430000,2067497083,23905807,3.227283945e-12,169683514,7072488,73839776
435000,2055277084,23839734,3.2183640900000003e-12,167536114,7025028,80864804
440000,2042066250,23930794,3.2306571900000002e-12,170495571,7087264,87952068
445000,2048001083,24084918,3.2514639300000005e-12,175014919,7186588,95138656
450000,4718962958,87093819,1.1757665565000001e-11,171536786,-24447184,70691472
455000,2068745125,23903161,3.226926735e-12,169597506,7069652,77761124
460000,2064649208,23842423,3.218727105e-12,167623527,7027792,84788916
465000,2070521250,23937523,3.2315656050000003e-12,170201517,7079108,91868024
470000,2069337041,23879284,3.2237033400000003e-12,168821515,7046736,98914760
475000,2041798500,23878375,3.2235806250000006e-12,168791951,7042460,105957220
480000,6464191750,91211098,1.2313498230000001e-11,167942148,-30548836,75408384
485000,2052778209,23863376,3.2215557600000003e-12,168304491,7052048,82460432
490000,2068286625,23843981,3.2189374350000002e-12,167674142,7022536,89482968
495000,2071999042,23849192,3.21964092e-12,167843522,7033868,96516836
500000,2038046125,23857523,3.2207656050000003e-12,167555775,7031060,103547896
505000,2069591667,24941465,3.367097775e-12,178739879,7196608,110744504
510000,4726454167,96409270,1.3015251450000003e-11,176035240,-30621144,80123360
515000,2062606583,24942461,3.3672322350000005e-12,178772233,7199328,87322688
520000,2044236041,25035156,3.3797460600000006e-12,181198080,7243092,94565780
525000,2053479625,25114652,3.3904780200000005e-12,184368449,7306252,101872032
530000,2071652000,25064171,3.3836630850000004e-12,182727830,7301396,109173428
535000,2071036708,25108883,3.389699205e-12,184180956,7324604,116498032
540000,6483050083,100808288,1.3609118880000001e-11,181607915,-31661520,84836512
545000,2070501334,25051033,3.3818894550000006e-12,182300836,7287500,92124012
550000,2064319584,25119707,3.3911604450000003e-12,184532754,7318816,99442828
555000,2052533833,25096395,3.3880133250000005e-12,183156957,7296140,106738968
560000,2069106417,25039882,3.3803840700000003e-12,181938411,7253884,113992852
565000,2049814625,25121463,3.3913975050000003e-12,184589820,7320960,121313812
570000,6479265709,105042829,1.4180781915000002e-11,182405892,-31762976,89550836
575000,2072171334,25129793,3.3925220550000004e-12,184860522,7320356,96871192
580000,2070852459,25076482,3.3853250700000006e-12,183127918,7306772,104177964
585000,2066571791,25057725,3.3827928750000004e-12,182518316,7292100,111470064
590000,2063346375,25064777,3.3837448950000004e-12,182747522,7285880,118755944
595000,2044358292,25091111,3.3872999850000004e-12,182957118,7298476,126054420
600000,2041501292,25087073,3.3867548550000005e-12,183472121,7305712,133360132
605000,8569858875,109949483,1.4843180205e-11,182199063,-38307844,95052288
610000,2056827667,25082073,3.3860798550000002e-12,183309621,7303504,102355792
615000,2070494500,25063030,3.3835090500000007e-12,182690754,7290236,109646028
620000,2067299250,25012967,3.376750545e-12,181063684,7253176,116899204
625000,2068635250,25119345,3.3911115750000006e-12,184520983,7317184,124216388
630000,2069911500,25025604,3.3784565400000005e-12,180776009,7254564,131470952
635000,2069191833,25105417,3.389231295e-12,184068307,7319660,138790612
640000,6463355625,114821347,1.5500881845000002e-11,181699763,-38241800,100548812
645000,2064542625,25075379,3.3851761650000005e-12,182361505,7285308,107834120
650000,2064050292,25064278,3.38367753e-12,182731285,7289920,115124040
655000,2070534709,25006994,3.37594419e-12,180869581,7235940,122359980
660000,2052657166,24939394,3.36681819e-12,178672579,7184328,129544308
665000,2068077292,24934115,3.366105525e-12,177770442,7186872,136731180
670000,2067552417,24906830,3.3624220500000005e-12,177614222,7177596,143908776
675000,6487928125,119630286,1.6150088610000003e-11,178417217,-37861004,106047772
680000,2063025916,24880851,3.3589148850000003e-12,176008345,7144840,113192612
685000,2064895958,24950798,3.3683577300000005e-12,179043184,7214384,120406996
690000,2070650667,25067652,3.3841330200000003e-12,182840940,7284440,127691436
695000,2072060833,24865211,3.356803485e-12,176261624,7150368,134841804
700000,2047085459,24933612,3.36603762e-12,178484666,7196196,142038000
705000,2067649375,25020582,3.3777785700000003e-12,180549602,7243892,149281892
710000,2062726875,25126235,3.392041725e-12,184744888,7319804,156601696
715000,8568248792,125412133,1.6930637955e-11,183162966,-44270976,112330720
720000,2057359084,25112215,3.3901490250000003e-12,184289240,7311936,119642656
725000,2059304083,25091154,3.3873057900000008e-12,183604755,7301688,126944344
730000,2060876250,25054535,3.3823622250000002e-12,182414643,7291528,134235872
735000,2069270500,25093918,3.38767893e-12,183694605,7317284,141553156
740000,2063033917,25070534,3.3845220900000005e-12,182116449,7278824,148831980
745000,2068957667,25092574,3.3874974900000003e-12,183650918,7317848,156149828
750000,2066552208,25095337,3.3878704950000002e-12,183740723,7306272,163456100
755000,6477119250,130975187,1.7681650245000002e-11,181525852,-44839244,118616856
760000,2047810166,25013667,3.3768450450000002e-12,181086431,7255908,125872764
765000,2053548708,25140030,3.3939040500000002e-12,185193255,7328368,133201132
770000,2072436791,25078539,3.3856027650000003e-12,183194794,7282168,140483300
775000,2070250333,25111009,3.3899862150000003e-12,184250050,7316912,147800212
780000,2050560417,25130637,3.3926359950000002e-12,184031064,7322860,155123072
785000,2068493292,25037516,3.3800646600000004e-12,181861518,7278428,162401500
790000,2051788291,25101121,3.388651335e-12,183928680,7317240,169718740
795000,2072332709,25092014,3.3874218900000003e-12,183632704,7319920,177038660
800000,8568660417,137292766,1.853452341e-11,181523284,-51346332,125692328
805000,2069519917,25076147,3.3852798450000004e-12,183117031,7305192,132997520
810000,2066648542,25104698,3.38913423e-12,183126977,7297816,140295336
815000,2072300458,25074068,3.38499918e-12,183049471,7296656,147591992
820000,2053434209,25111827,3.3900966450000005e-12,184276649,7311160,154903152
825000,2049996541,25069628,3.3843997800000005e-12,182905180,7286336,162189488
830000,2073044583,25058695,3.382923825e-12,182549854,7292452,169481940
835000,2072806875,25096914,3.3880833900000005e-12,182873989,7295928,176777868
840000,2039455167,25108359,3.3896284650000002e-12,184163931,7328280,184106148
845000,8576238167,143812844,1.9414733940000002e-11,188237764,-51344736,132761412
850000,2057228666,25203920,3.4025292000000004e-12,187269675,7396640,140158052
855000,2071071125,25297852,3.41521002e-12,190322443,7440096,147598148
860000,2066118375,25248241,3.4085125350000003e-12,188710077,7406104,155004252
865000,2068066209,25233841,3.406568535e-12,188242092,7397680,162401932
870000,2073085167,25280589,3.4128795150000003e-12,188801223,7401828,169803760
875000,2051757000,25259704,3.41006004e-12,189082647,7417788,177221548
880000,2068340375,25251666,3.4089749100000003e-12,188821403,7420560,184642108
885000,2058071708,25221589,3.4049145150000004e-12,187843906,7391880,192033988
890000,8550687417,150164837,2.0272252995000003e-11,189471717,-52203060,139830928
895000,2067284875,25235571,3.4068020850000005e-12,188298319,7408128,147239056
900000,2049226833,25284621,3.4134238350000005e-12,189892440,7437172,154676228
905000,2051491167,25242823,3.4077811050000007e-12,187529424,7394312,162070540
910000,2057571333,25247850,3.40845975e-12,188697370,7414456,169484996
915000,2072326333,25288635,3.413965725e-12,190022899,7437068,176922064
920000,2072208709,25265167,3.4107975450000003e-12,189260191,7416704,184338768
925000,2068983416,25271915,3.4117085250000006e-12,189479490,7415924,191754692
930000,2048120667,25244376,3.4079907600000004e-12,187579916,7398940,199153632
935000,2073734750,25249059,3.4086229650000005e-12,188736668,7423116,206576748
940000,8579396000,157165711,2.1217370985000004e-11,188974207,-58890540,147686208
945000,2053560750,25238145,3.4071495750000006e-12,188381960,7398352,155084560
950000,2053357834,25267561,3.4111207350000006e-12,189337989,7429220,162513780
955000,2052042083,25194611,3.401272485e-12,186967114,7386120,169899900
960000,2063816667,25275154,3.4121457900000005e-12,189584784,7440160,177340060
965000,2049915667,25284421,3.4133968350000002e-12,188815115,7408612,184748672
970000,2069471292,25081482,3.3860000700000005e-12,183290423,7306120,192054792
975000,2070631166,25106955,3.3894389250000003e-12,184118311,7327800,199382592
980000,2069509125,25181891,3.3995552850000003e-12,186553722,7391984,206774576
985000,2037338459,25240961,3.407529735e-12,187402642,7410240,214184816
990000,8578916542,164150245,2.2160283075000004e-11,188936866,-58634972,155549844
995000,2074092000,25248451,3.408540885e-12,187600352,7409972,162959816
1000000,2061205750,25240930,3.4075255500000004e-12,188472490,7436300,170396116
1005000,2054183417,25195206,3.4013528100000003e-12,186986449,7408096,177804212
1010000,2065997333,25216812,3.4042696200000007e-12,187688654,7417932,185222144
1015000,2073463750,25241883,3.407654205e-12,188503457,7429824,192651968
1020000,2069065250,25076896,3.3853809600000005e-12,182024820,7280992,199932960
1025000,2062126167,25152584,3.3955988400000003e-12,185601230,7348388,207281348
1030000,2034252166,25228904,3.4059020400000005e-12,188081627,7407172,214688520
1035000,2053386708,25232206,3.4063478100000004e-12,188188948,7405000,222093520
1040000,2040516125,25273074,3.4118649900000007e-12,188400593,7402044,229495564
1045000,8548281417,171827880,2.3196763800000004e-11,187629577,-65300728,164194836
1050000,2047690334,25275309,3.412166715e-12,188402478,7404192,171599028
1055000,2063572625,25209940,3.4033419000000002e-12,187465307,7382172,178981200
1060000,2066061292,25292640,3.4145064000000005e-12,190153071,7434912,186416112
1065000,2071192375,25247865,3.4084617750000004e-12,188697857,7412208,193828320
1070000,2067824083,25286289,3.4136490150000003e-12,189946661,7435480,201263800
1075000,2046345125,25256899,3.4096813650000004e-12,187804142,7400020,208663820
1080000,2065488667,25250634,3.40883559e-12,188787877,7417464,216081284
1085000,2066128125,25241153,3.4075556550000002e-12,188479732,7415324,223496608
1090000,2068684667,25239975,3.4073966250000007e-12,188441450,7407416,230904024
1095000,2068776833,25216602,3.40424127e-12,187681816,7386260,238290284
1100000,2039596250,25318159,3.4179514650000004e-12,189795089,7440740,245731024
1105000,11081255542,180323047,2.4343611345000002e-11,188900932,-72109512,173621512
1110000,2071980666,25219811,3.4046744850000005e-12,187786125,7402112,181023624
1115000,2037880000,25180120,3.3993162000000003e-12,186496148,7365360,188388984
1120000,2068130000,25268494,3.4112466900000005e-12,189368332,7433528,195822512
1125000,2058853875,25272677,3.4118113950000003e-12,188240996,7406888,203229400
1130000,2055444500,25200744,3.40210044e-12,187166456,7390504,210619904
1135000,2063916209,25080676,3.3858912600000002e-12,183264217,7300856,217920760
1140000,2041069500,25121710,3.3914308500000003e-12,184597850,7328676,225249436
1145000,2042502416,25238260,3.4071651000000007e-12,188385715,7413872,232663308
1150000,2047622834,25163624,3.3970892400000003e-12,184696755,7330880,239994188
1155000,2062160875,25109753,3.389816655e-12,184209241,7320264,247314452
1160000,2057097333,25065076,3.3837852600000002e-12,182757239,7288232,254602684
1165000,11087428625,188594948,2.5460317980000002e-11,184149094,-71555672,183047012
1170000,2044147500,25083567,3.3862815450000002e-12,183358186,7289404,190336416
1175000,2045419041,25086250,3.3866437500000003e-12,183445400,7303980,197640396
1180000,2066737000,25310990,3.4169836500000003e-12,189432280,7421772,205062168
1185000,2067954708,25202360,3.4023186000000004e-12,187218970,7380800,212442968
1190000,2066875333,25266613,3.4109927550000004e-12,189307172,7419924,219862892
1195000,2051567833,25192932,3.4010458200000005e-12,186912552,7370652,227233544
1200000,2072329833,25263660,3.4105941000000007e-12,189211209,7432608,234666152
1205000,2041257166,25252512,3.4090891200000004e-12,187531736,7391276,242057428
1210000,2052755584,25293812,3.4146646200000003e-12,190191153,7442248,249499676
1215000,2067551375,25230213,3.4060787550000007e-12,188124173,7400724,256900400
1220000,2068616667,25271928,3.4117102800000002e-12,189479928,7443520,264343920
1225000,2061042458,25328901,3.419401635e-12,190014395,7443648,271787568
1230000,11092581916,197836216,2.6707889160000002e-11,187928090,-78521120,193266448
1235000,2073211416,25229412,3.4059706200000004e-12,188098147,7414604,200681052
1240000,2065306166,25221667,3.4049250450000006e-12,187846440,7403108,208084160
1245000,3253931291,25237374,3.4070454900000003e-12,188356898,7418044,215502204
1250000,2059440791,25317173,3.417818355e-12,189552051,7437068,222939272
1255000,2067970792,25217628,3.4043797800000006e-12,187715158,7401860,230341132
1260000,2073405583,25243029,3.4078089150000007e-12,188540692,7411168,237752300
1265000,2067921709,25224985,3.4053729750000006e-12,187954286,7392388,245144688
1270000,2072072083,25283343,3.4132513050000004e-12,189850909,7432780,252577468
1275000,2069042208,25309247,3.4167483450000004e-12,189294456,7429508,260006976
1280000,2066706875,25249543,3.4086883050000006e-12,188752398,7429036,267436012
1285000,2069707292,25234817,3.4067002950000003e-12,188273822,7418056,274854068
1290000,2075889750,25151238,3.3954171300000003e-12,185557503,7353976,282208044
1295000,2068987375,25094512,3.38775912e-12,183713887,7314792,289522836
1300000,11067281541,207512462,2.8014182370000004e-11,182822636,-85255460,204267376
1305000,2065793584,25126577,3.392087895e-12,184756004,7338128,211605504
1310000,2070702292,25298400,3.4152840000000003e-12,190340250,7430500,219036004
1315000,2069327958,25251672,3.4089757200000004e-12,188821609,7409360,226445364
1320000,2068721542,25191386,3.4008371100000007e-12,186862287,7353164,233798528
1325000,2059855209,25297225,3.415125375e-12,190302057,7438340,241236868
1330000,2071377917,25293954,3.4146837900000002e-12,188712714,7411744,248648612
1335000,2068635250,25229908,3.4060375800000004e-12,188114282,7405088,256053700
1340000,2067034417,25266098,3.4109232300000003e-12,189290441,7417952,263471652
1345000,2035985750,25251991,3.4090187850000005e-12,188831982,7415656,270887308
1350000,2063075416,25243002,3.4078052700000005e-12,188539818,7413164,278300472
1355000,2059810625,25274188,3.4120153800000002e-12,188070325,7404124,285704596
1360000,2060359417,25227283,3.4056832050000006e-12,188028953,7381624,293086220
1365000,2049890416,25255206,3.4094528100000007e-12,188936447,7410340,300496560
1370000,11053386584,217535060,2.93672331e-11,189721664,-85235632,215260928
1375000,2059861334,25232368,3.4063696800000006e-12,188194212,7400860,222661788
1380000,2060213667,25230297,3.4060900950000007e-12,188126915,7411116,230072904
1385000,2046938458,25286695,3.4137038250000005e-12,188411535,7414092,237486996
1390000,2059886875,25233311,3.4064969850000004e-12,188224865,7417756,244904752
1395000,2060774459,25281174,3.4129584900000003e-12,189780432,7441772,252346524
1400000,2059710500,25246370,3.4082599500000006e-12,188649291,7425064,259771588
1405000,2062353250,25329294,3.41945469e-12,189795996,7440812,267212400
1410000,2038762500,25270126,3.41146701e-12,189421376,7422836,274635236
1415000,2060115916,25235453,3.4067861550000003e-12,188294474,7402488,282037724
1420000,2059906709,25225520,3.4054452000000003e-12,187971663,7400260,289437984
1425000,2057844167,25261501,3.410302635e-12,189141035,7425288,296863272
1430000,2063972834,25274259,3.412024965e-12,188007347,7409760,304273032
1435000,2059455708,25234612,3.4066726200000005e-12,188267151,7415776,311688808
1440000,2049395333,25207652,3.40303302e-12,187390938,7401240,319090048
1445000,11050405791,228048887,3.0786599745000005e-11,189268480,-92039320,227050728
1450000,2063118042,25113711,3.3903509850000006e-12,184337872,7330296,234381024
1455000,2050934833,25088675,3.3869711250000003e-12,183524208,7317068,241698092
1460000,2058556167,25132846,3.3929342100000003e-12,183321497,7302644,249000736
1465000,2062503708,25144406,3.3944948100000004e-12,185335474,7348408,256349144
1470000,2062111042,25294731,3.4147886850000004e-12,190221032,7447288,263796432
1475000,2043373375,25243968,3.4079356800000003e-12,188571209,7407824,271204256
1480000,2059803625,25276891,3.4123802850000003e-12,189641234,7443016,278647272
1485000,2059030417,25246095,3.4082228250000002e-12,187002078,7401904,286049176
1490000,2062969042,25212598,3.40370073e-12,187551683,7415280,293464456
1495000,2048133791,25239854,3.40738029e-12,188437507,7435304,300899760
1500000,2060284208,25191356,3.40083306e-12,186861333,7397564,308297324
1505000,2059585125,25219307,3.404606445e-12,187769755,7408120,315705444
1510000,2064346750,25254893,3.4094105550000003e-12,187288017,7387456,323092900
1515000,2046669958,25226941,3.4056370350000004e-12,188017841,7407124,330500024
1520000,2058282625,25264324,3.4106837400000002e-12,189232799,7434436,337934460
1525000,14081000208,239255476,3.229948926e-11,188330824,-98306528,239627932
1530000,2057914333,25336404,3.4204145400000005e-12,189844319,7437092,247065024
1535000,2059388083,25206257,3.402844695e-12,187345626,7391636,254456660
1540000,2054938959,25245171,3.408098085e-12,188610332,7419024,261875684
1545000,2059815292,25277273,3.4124318550000003e-12,189653625,7440832,269316516
1550000,2057424125,25223513,3.4051742550000004e-12,187906419,7408336,276724852
1555000,2057356584,25320788,3.4183063800000004e-12,189336777,7438348,284163200
1560000,2059898791,25215586,3.4041041100000004e-12,187648808,7398588,291561788
1565000,2059069542,25236526,3.4069310100000006e-12,188329344,7416244,298978032
1570000,2047688333,25213138,3.4037736300000005e-12,187569233,7395552,306373584
1575000,2062083125,25213390,3.4038076500000005e-12,187577454,7407420,313781004
1580000,2060107917,25313817,3.4173652950000007e-12,189110229,7437104,321218108
1585000,2058784083,25208194,3.4031061900000006e-12,187408553,7399664,328617772
1590000,2063360333,25274366,3.4120394100000002e-12,189559176,7441856,336059628
1595000,2061381542,25220570,3.4047769500000006e-12,187810783,7399100,343458728
1600000,2051688750,25259637,3.4100509950000003e-12,189080455,7427076,350885804
1605000,2075839166,25294921,3.4148143350000002e-12,188496113,7417912,358303716
1610000,14088103917,251192092,3.3910932420000004e-11,188726192,-105316800,252986916
1615000,2057761084,25288461,3.4139422350000005e-12,190017232,7449848,260436764
1620000,2048105875,25245758,3.40817733e-12,188629406,7419180,267855944
1625000,2066581792,25370369,3.4249998150000007e-12,190848380,7445816,275301760
1630000,2064333667,25426073,3.432519855e-12,194489635,7547140,282848900
1635000,2068336167,25401369,3.4291848150000004e-12,193686750,7517112,290366012
1640000,2071281833,25391178,3.4278090300000006e-12,193355562,7518652,297884664
1645000,2070691292,25422160,3.4319916000000003e-12,194362454,7541748,305426412
1650000,2050733667,25426149,3.4325301150000005e-12,192661209,7511036,312937448
1655000,2065533916,25435775,3.4338296250000003e-12,194804946,7547172,320484620
1660000,2064136250,25406746,3.4299107100000004e-12,193861487,7526448,328011068
1665000,2069183583,25465657,3.4378636950000007e-12,195776098,7568500,335579568
1670000,2062450209,25461873,3.4373528550000004e-12,195653119,7558200,343137768
1675000,2037897708,25459449,3.4370256150000006e-12,193743468,7519252,350657020
1680000,2059538583,25452654,3.4361082900000005e-12,195353517,7559344,358216364
1685000,2073545167,25372617,3.4253032950000004e-12,192752305,7509160,365725524
1690000,2065638875,25448659,3.4355689650000006e-12,195223682,7555812,373281336
1695000,14089487917,263322641,3.5548556535e-11,193307238,-106943560,266337776
1700000,2077275334,25426036,3.4325148600000003e-12,194488426,7538288,273876064
1705000,2066590708,25247558,3.40842033e-12,188687914,7412548,281288612
1710000,2062841125,25298294,3.4152696900000004e-12,190336813,7436472,288725084
1715000,2046522542,25258975,3.4099616250000003e-12,189058947,7406532,296131616
1720000,2062774750,25302732,3.4158688200000004e-12,188566289,7402372,303533988
1725000,2069715292,25304592,3.4161199200000003e-12,190541494,7431284,310965272
1730000,2069563083,25238865,3.4072467750000002e-12,188405363,7407136,318372408
1735000,2067346250,25295685,3.4149174750000007e-12,190252009,7437552,325809960
1740000,2050377584,25375398,3.4256787300000007e-12,192842683,7502068,333312028
1745000,2042882250,25386421,3.4271668350000005e-12,191286173,7462216,340774244
1750000,2047537917,25253770,3.40925895e-12,188889798,7406948,348181192
1755000,2064142209,25259386,3.41001711e-12,189072301,7419036,355600228
1760000,2072991250,25300008,3.41550108e-12,190392512,7435856,363036084
1765000,2070366709,25238841,3.407243535e-12,188404603,7393584,370429668
1770000,2069259375,25290346,3.4141967100000003e-12,188163732,7401768,377831436
1775000,2042566583,25264870,3.4107574500000004e-12,189250527,7428072,385259508
1780000,2053940500,25265835,3.410887725e-12,189281890,7432088,392691596
1785000,17683293792,275853640,3.72402414e-11,190034509,-112214560,280477036
1790000,2051542250,25409859,3.430330965e-12,193962671,7538156,288015192
1795000,2063884958,25389819,3.4276255650000006e-12,193311395,7524972,295540164
1800000,2071265166,25432851,3.4334348850000007e-12,194709933,7553448,303093612
1805000,2065761209,25482108,3.44008458e-12,194296972,7534764,310628376
1810000,2064331958,25419804,3.43167354e-12,194285883,7537892,318166268
1815000,2052778167,25457393,3.4367480550000002e-12,195507519,7546776,325713044
1820000,2059751709,25420732,3.4317988200000007e-12,194316044,7534320,333247364
1825000,2044875625,25384301,3.4268806350000005e-12,193132028,7496180,340743544
1830000,2050345083,25521489,3.4454010150000003e-12,195576861,7563376,348306920
1835000,2044268000,25398626,3.4288145100000005e-12,193597606,7525160,355832080
1840000,2035148459,25431998,3.4333197300000002e-12,194682212,7549912,363381992
1845000,2061340000,25391045,3.4277910750000005e-12,193351223,7517192,370899184
1850000,2059688750,25429698,3.4330092300000003e-12,194607431,7544700,378443884
1855000,2042271083,25470027,3.4384536450000004e-12,193904333,7540576,385984460
1860000,2043803000,25411568,3.4305616800000003e-12,194018208,7515828,393500288
1865000,2065457750,25405219,3.4297045650000004e-12,193811867,7521012,401021300
1870000,2060688166,25427747,3.4327458450000005e-12,194544049,7537052,408558352
1875000,2047481042,25415504,3.4310930400000005e-12,194146146,7535340,416093692
1880000,17662898167,289335226,3.906025551000001e-11,194873184,-120687920,295405772
1885000,2048525875,25353399,3.4227088650000005e-12,192127718,7511132,302916904
1890000,2037933417,25429230,3.4329460500000004e-12,194592252,7564376,310481280
1895000,2050992875,25515572,3.4446022200000003e-12,195270799,7565660,318046940
1900000,2071023042,25311323,3.4170286050000007e-12,190760254,7465564,325512504
1905000,2013164875,25288337,3.4139254950000006e-12,190013224,7441044,332953548
1910000,2038324000,25250943,3.4088773050000002e-12,188797904,7406188,340359736
1915000,2034562708,25293535,3.414627225e-12,190182139,7428288,347788024
1920000,2038102041,25316027,3.417663645e-12,188785596,7419424,355207448
1925000,2037694208,25217646,3.4043822100000002e-12,187715753,7391880,362599328
1930000,2048546000,25246281,3.4082479350000006e-12,188646397,7426320,370025648
1935000,2059600167,25304574,3.4161174900000003e-12,190540913,7460724,377486372
1940000,2037847833,25440821,3.4345108350000002e-12,194968928,7551012,385037384
1945000,2053848542,25396835,3.428572725e-12,193539412,7528920,392566304
1950000,2038992625,25450759,3.4358524650000003e-12,195291939,7540560,400106864
1955000,2055058792,25402875,3.4293881250000003e-12,193735712,7533592,407640456
1960000,2062376208,25430007,3.4330509450000005e-12,194617489,7533472,415173928
1965000,2042324916,25460468,3.4371631800000003e-12,193479908,7509712,422683640
1970000,2044473833,25448842,3.4355936700000006e-12,195229642,7547812,430231452
1975000,2054814333,25422329,3.432014415e-12,194367954,7536400,437767852
1980000,17677461458,303312405,4.0947174675e-11,195009644,-126646120,311121732
1985000,2058750625,25391951,3.427913385e-12,193380683,7530632,318652364
1990000,2062018333,25400401,3.4290541350000003e-12,193655299,7524720,326177084
1995000,2055054417,25431202,3.4332122700000003e-12,194656319,7555464,333732548
2000000,2044490334,25387267,3.4272810450000003e-12,193228440,7528656,341261204
2005000,2057087042,25505473,3.4432388550000006e-12,194831923,7564000,348825204
2010000,2046870459,25387811,3.4273544850000006e-12,193246113,7526372,356351576
2015000,2036175083,25350492,3.42231642e-12,192033252,7497144,363848720
2020000,2043151041,25454026,3.43629351e-12,195398125,7566004,371414724
2025000,2052044167,25376743,3.4258603050000005e-12,192886411,7506560,378921284
2030000,2034536375,25478222,3.4395599700000005e-12,193946279,7546516,386467800
2035000,2043454833,25432217,3.4333492950000003e-12,194689320,7546496,394014296
2040000,2036948417,25425994,3.4325091900000005e-12,194487058,7544768,401559064
2045000,2059582417,25455785,3.4365309750000003e-12,195455271,7559708,409118772
2050000,2041696042,25379038,3.4261701300000004e-12,192960989,7514884,416633656
2055000,2044480208,25500195,3.4425263250000006e-12,194660391,7542552,424176208
2060000,2060904583,25407915,3.430068525e-12,193899487,7515104,431691312
2065000,2060341459,25360626,3.42368451e-12,192362604,7479364,439170676
2070000,2037652833,25302051,3.4157768850000005e-12,190458920,7434196,446604872
2075000,2043085041,25232554,3.4063947900000002e-12,188200248,7399832,454004704
2080000,2061113667,25304476,3.4161042600000005e-12,188299513,7407196,461411900
2085000,17681549250,317835847,4.290783934500001e-11,188365502,-133790940,327620960
2090000,2049718708,25274524,3.4120607400000002e-12,187207889,7379876,335000836
2095000,2041939333,25299417,3.4154212950000005e-12,190373312,7451636,342452472
2100000,2044071666,25266328,3.4109542800000004e-12,189297923,7430904,349883376
2105000,2056733958,25204261,3.402575235e-12,187280741,7391004,357274380
2110000,2040514291,25257477,3.4097593950000004e-12,189010253,7416460,364690840
2115000,2038727417,25396447,3.4285203450000004e-12,191170381,7460472,372151312
2120000,2056605000,25481969,3.4400658150000006e-12,196306250,7562404,379713716
2125000,2021631708,25419550,3.4316392500000005e-12,194277647,7534036,387247752
2130000,2053954041,25426456,3.43257156e-12,194502088,7544860,394792612
2135000,2061471375,25410689,3.4304430150000005e-12,193989663,7526388,402319000
2140000,2056447542,25506325,3.4433538750000005e-12,194741417,7549692,409868692
2145000,2043524042,25445034,3.4350795900000004e-12,195105882,7552400,417421092
2150000,2050471083,25380684,3.4263923400000008e-12,193014496,7518100,424939192
2155000,2049540958,25405425,3.4297323750000003e-12,193818566,7528236,432467428
2160000,2046053333,25445770,3.43517895e-12,195129786,7535644,440003072
2165000,2047484250,25474348,3.43903698e-12,193702155,7512092,447515164
2170000,2047150375,25440702,3.4344947700000003e-12,194965074,7539460,455054624
2175000,2037043750,25406598,3.4298907300000003e-12,193856708,7511172,462565796
2180000,2039832584,25455639,3.4365112650000005e-12,195450530,7560668,470126464
2185000,2044355292,25381758,3.4265373300000008e-12,193049395,7514312,477640776
2190000,2060030667,25471351,3.438632385e-12,193604753,7526348,485167124
2195000,17656146083,333471628,4.5018669780000005e-11,194860595,-140262152,344904972
2200000,2035542417,25412810,3.4307293500000003e-12,194058585,7526772,352431744
2205000,2059885791,25534790,3.44719665e-12,195544823,7555468,359987212
2210000,2055925625,25425202,3.43240227e-12,194461308,7539340,367526552
2215000,2059469625,25385275,3.4270121250000008e-12,193163704,7508384,375034936
2220000,2041430834,25235591,3.4068047850000004e-12,188298975,7402120,382437056
2225000,2055648166,25220941,3.404827035e-12,187822840,7400956,389838012
2230000,2055306000,25351934,3.4225110900000003e-12,189601982,7425424,397263436
2235000,2015996166,25351390,3.4224376500000008e-12,192062453,7482004,404745440
2240000,2047225959,25462189,3.4373955150000004e-12,195663405,7558996,412304436
2245000,2061471375,25413750,3.43085625e-12,194089129,7522388,419826824
2250000,2059791792,25437652,3.4340830200000005e-12,194865943,7538100,427364924
2255000,2059192292,25507701,3.4435396350000004e-12,194664430,7546124,434911048
2260000,2041592000,25419385,3.431616975e-12,194272276,7531296,442442344
2265000,2053636542,25476442,3.4393196700000007e-12,196126620,7561452,450003796
2270000,2060522041,25411071,3.430494585e-12,194002079,7529992,457533788
2275000,2069703666,25446813,3.4353197550000005e-12,195163689,7544392,465078180
2280000,2070171750,25486158,3.4406313300000003e-12,193964278,7526020,472604200
2285000,2046524708,25441118,3.4345509300000005e-12,194978614,7549296,480153496
2290000,2063286125,25426242,3.4325426700000003e-12,194495131,7539980,487693476
2295000,2064971625,25417771,3.4313990850000005e-12,194219816,7530092,495223568
2300000,2071673208,25413662,3.4308443700000002e-12,194086268,7534804,502758372
2305000,2064295458,25438559,3.4342054650000003e-12,192417292,7495236,510253608
2310000,17656295084,349654528,4.720336128e-11,196042496,-147277628,362975980
2315000,2073753833,25418353,3.4314776550000003e-12,194238724,7524388,370500368
2320000,2042517875,25475415,3.439181025e-12,193487418,7510724,378011092
2325000,2058660083,25459674,3.43705599e-12,195581650,7553812,385564904
2330000,2077592833,25410624,3.4304342400000003e-12,193987544,7533252,393098156
2335000,2062982584,25435814,3.43383489e-12,194806219,7553232,400651388
2340000,2061730917,25498103,3.4422439050000006e-12,194224779,7532176,408183564
2345000,2068582167,25431566,3.4332614100000003e-12,194668171,7548936,415732500
2350000,2045723750,25407425,3.4300023750000007e-12,193883569,7522748,423255248
2355000,2047895042,25430060,3.4330581e-12,194619225,7545396,430800644
2360000,2070303375,25467851,3.4381598850000004e-12,195847425,7558384,438359028
2365000,2068276250,25330467,3.419613045e-12,188776628,7413952,445772980
2370000,2072784917,25303453,3.4159661550000005e-12,190504471,7446328,453219308
2375000,2065367166,25385035,3.4269797250000002e-12,193155889,7495592,460714900
2380000,2070799000,25452010,3.4360213500000005e-12,195332569,7559892,468274792
2385000,2047613208,25409330,3.43025955e-12,193945489,7531908,475806700
2390000,2071979334,25456703,3.436654905e-12,192879291,7514296,483320996
2395000,2069686791,25408903,3.430201905e-12,193931602,7514920,490835916
2400000,2069193208,25400452,3.4290610200000007e-12,193656960,7503032,498338948
2405000,2065261375,25401304,3.42917604e-12,193684637,7519244,505858192
2410000,2063569500,25248975,3.408611625e-12,188733946,7418584,513276776
2415000,2042448291,25281520,3.4130052000000003e-12,187185837,7383140,520659916
2420000,2053272000,25269975,3.4114466250000004e-12,189416457,7427060,528086976
2425000,2065181125,25355335,3.4229702250000004e-12,192190644,7482492,535569468
2430000,2063750500,25443354,3.4348527900000004e-12,195051256,7551804,543121272
2435000,21994012417,367215002,4.9574025270000004e-11,193345371,-160505240,382616032
2440000,2040296542,25435558,3.4338003300000006e-12,194797901,7550544,390166576
2445000,2042108000,25531754,3.4467867900000006e-12,195163429,7543404,397709980
2450000,2037142875,25380030,3.4263040500000004e-12,192993231,7508024,405218004
2455000,2054356834,25454199,3.436316865e-12,195403744,7555940,412773944
2460000,2048331208,25435948,3.4338529800000003e-12,194810557,7541468,420315412
2465000,2058827000,25388016,3.4273821600000004e-12,193252794,7516008,427831420
2470000,2046302125,25560783,3.4507057050000005e-12,196106883,7564612,435396032
2475000,2036101292,25389534,3.42758709e-12,193302124,7515984,442912016
2480000,2041234042,25428881,3.4328989350000003e-12,194580890,7558108,450470124
2485000,2041867958,25350488,3.42231588e-12,192033122,7508116,457978240
2490000,2038665667,25432133,3.4333379550000003e-12,194686573,7564228,465542468
2495000,2059677333,25452234,3.4360515900000005e-12,192579017,7519840,473062308
2500000,2037192875,25378832,3.4261423200000005e-12,192954307,7527904,480590212
2505000,2035910667,25394737,3.4282894950000004e-12,193471213,7530776,488120988
2510000,2059505208,25409339,3.4302607650000007e-12,193945778,7546328,495667316
2515000,2043848042,25433357,3.4335031950000002e-12,194726365,7552324,503219640
2520000,2050720208,25474625,3.4390743750000003e-12,193306737,7523652,510743292
2525000,2048767083,25444822,3.4350509700000007e-12,195098968,7554760,518298052
2530000,2040362334,25519541,3.4451380350000006e-12,197527355,7612164,525910216
2535000,2054045167,25409367,3.4302645450000007e-12,193946692,7530700,533440916
2540000,2050645125,25426303,3.4325509050000003e-12,194497113,7550880,540991796
2545000,2035642416,25471326,3.4386290100000006e-12,193199520,7529880,548521676
2550000,2051581541,25414314,3.4309323900000003e-12,194107471,7546100,556067776
2555000,2052892125,25426948,3.43263798e-12,194518068,7541788,563609564
2560000,2040783042,25409283,3.4302532050000007e-12,193943962,7528296,571137860
2565000,21990968000,385526643,5.2046096805e-11,195691639,-168094980,403042880
2570000,2038949666,25511871,3.4441025850000006e-12,197278067,7595652,410638532
2575000,2092309833,25640938,3.4615266300000004e-12,198568468,7622272,418260804
2580000,2067930834,25579790,3.4532716500000004e-12,199485450,7647844,425908648
2585000,2070133792,25572474,3.45228399e-12,199247657,7641732,433550380
2590000,2072891959,25557460,3.4502571000000006e-12,198759705,7634624,441185004
2595000,2066941416,25588684,3.4544723400000004e-12,199774478,7654892,448839896
2600000,2075726583,25637729,3.4610934150000004e-12,198464177,7631568,456471464
2605000,2068017875,25605896,3.45679596e-12,200333878,7680844,464152308
2610000,2074409833,25587186,3.45427011e-12,199725810,7655772,471808080
2615000,2069178000,25615685,3.4581174750000004e-12,200652035,7674284,479482364
2620000,2062428916,25628817,3.4598902950000004e-12,201078799,7676592,487158956
2625000,2068297041,25660375,3.4641506250000003e-12,199200193,7644984,494803940
2630000,2067974958,25575062,3.45263337e-12,199331762,7645200,502449140
2635000,2041116625,25558697,3.4504240950000003e-12,198799921,7637980,510087120
2640000,2069436917,25563249,3.4510386150000005e-12,198947866,7630760,517717880
2645000,2069729875,25554298,3.4498302300000004e-12,198656958,7639176,525357056
2650000,2069498166,25701483,3.469700205e-12,200536179,7675828,533032884
2655000,2068537875,25555646,3.4500122100000003e-12,198700756,7644772,540677656
2660000,2069528083,25531164,3.4467071400000007e-12,197905099,7616148,548293804
2665000,2073214584,25612625,3.4577043750000006e-12,200552558,7661224,555955028
2670000,2055019459,25549375,3.4491656250000002e-12,198496943,7617444,563572472
2675000,2070521209,25719222,3.4720949700000006e-12,201112726,7671564,571244036
2680000,2071683833,25398640,3.4288164000000003e-12,193598061,7527924,578771960
2685000,2065446750,25410746,3.4304507100000003e-12,193991498,7535408,586307368
2690000,2069575791,25461922,3.4373594700000005e-12,195654724,7568072,593875440
2695000,2068174875,25556164,3.4500821400000005e-12,198717581,7632100,601507540
2700000,22000368375,404694723,5.463378760500001e-11,200377884,-177246360,424261180
2705000,2059206083,25645178,3.4620990300000005e-12,201610544,7683924,431945104
2710000,2054027209,25559101,3.4504786350000006e-12,198813029,7635380,439580484
2715000,2050857334,25575460,3.4526871000000002e-12,199344700,7646352,447226836
2720000,2071860166,25572800,3.452328e-12,199258263,7625772,454852608
2725000,2067439750,25667616,3.4651281600000004e-12,199282618,7638928,462491536
2730000,2036233792,25607490,3.4570111500000003e-12,200385689,7660752,470152288
2735000,2060647791,25559331,3.4505096850000003e-12,198820520,7634612,477786900
2740000,2060185917,25634214,3.4606188900000003e-12,201254219,7683564,485470464
2745000,2067456667,25558363,3.4503790050000006e-12,198789048,7625052,493095516
2750000,2038509250,25677468,3.46645818e-12,199602839,7652212,500747728
2755000,2055594292,25634485,3.4606554750000005e-12,201263030,7679832,508427560
2760000,2070538875,25602477,3.456334395e-12,200222771,7652232,516079792
2765000,2071411583,25652631,3.4631051850000003e-12,201852767,7677012,523756804
2770000,2047651125,25579897,3.453286095e-12,199488922,7633240,531390044
2775000,2065082208,25729868,3.4735321800000003e-12,201305834,7667452,539057496
2780000,2052645291,25551122,3.44940147e-12,198553735,7636852,546694348
2785000,2052567000,25575599,3.4527058650000005e-12,199349241,7649184,554343532
2790000,2061535708,25626330,3.4595545500000003e-12,200997983,7685880,562029412
2795000,2072113958,25683271,3.4672415850000003e-12,199791435,7654704,569684116
2800000,2058041042,25618281,3.458467935e-12,200736391,7683004,577367120
2805000,2050725708,25585248,3.4540084800000003e-12,199662817,7648856,585015976
2810000,2131434583,25601475,3.4561991250000005e-12,200190215,7664936,592680912
2815000,2071655333,25555626,3.4500095100000004e-12,198700109,7627816,600308728
2820000,2057941458,25697950,3.4692232500000003e-12,200268483,7659716,607968444
2825000,2056652375,25474206,3.4390178100000005e-12,196053976,7574780,615543224
2830000,2068036084,25426300,3.4325505000000002e-12,194497019,7545060,623088284
2835000,2070553250,25399749,3.428966115e-12,193634087,7533416,630621700
2840000,22012249833,424140063,5.725890850500001e-11,195270470,-184358852,446262848
2845000,2060110292,25580477,3.453364395e-12,199507775,7644700,453907548
2850000,2063177166,25576168,3.4527826800000003e-12,199367713,7649368,461556916
2855000,2049265375,25704741,3.4701400350000005e-12,200338442,7666128,469223044
2860000,2058667125,25585607,3.4540569450000003e-12,199674500,7647644,476870688
2865000,2060788625,25625675,3.4594661250000006e-12,200976716,7666176,484536864
2870000,2061102167,25626124,3.4595267400000004e-12,200991298,7667676,492204540
2875000,2057619333,25538545,3.447703575e-12,198144967,7619020,499823560
2880000,2057403125,25710996,3.4709844600000005e-12,200541725,7674624,507498184
2885000,2058998958,25570383,3.4520017050000002e-12,199179717,7651268,515149452
2890000,2060786083,25577200,3.4529220000000005e-12,199401276,7649508,522798960
2895000,2050944000,25570084,3.4519613400000005e-12,199170002,7643916,530442876
2900000,2055955375,25576139,3.452778765e-12,199366783,7648732,538091608
2905000,2059403875,25633391,3.460507785e-12,198019572,7623752,545715360
2910000,2058795334,25626324,3.45955374e-12,200997783,7672420,553387780
2915000,2060669500,25587815,3.454355025e-12,199746247,7640212,561027992
2920000,2050195417,25609977,3.4573468950000004e-12,200466521,7659532,568687524
2925000,2059984375,25597167,3.4556175450000005e-12,200050178,7655216,576342740
2930000,2060600375,25675962,3.4662548700000002e-12,199403124,7641656,583984396
2935000,2041852208,25621224,3.4588652400000006e-12,200832051,7677572,591661968
2940000,2037257125,25575589,3.452704515e-12,199348906,7653672,599315640
2945000,2034538458,25628890,3.4599001500000007e-12,201081204,7683612,606999252
2950000,2053080875,25575971,3.452756085e-12,199361317,7653380,614652632
2955000,2048050166,25692631,3.4685051850000003e-12,199944840,7666536,622319168
2960000,2054336167,25563689,3.4510980150000005e-12,198962153,7641532,629960700
2965000,2054032083,25551950,3.4495132500000006e-12,198580637,7625768,637586468
2970000,2070983791,25546731,3.4488086850000003e-12,198411036,7627004,645213472
2975000,2055487584,25551885,3.449504475e-12,198578508,7635116,652848588
2980000,2062730458,25474995,3.4391243250000005e-12,192871695,7522672,660371260
2985000,2050318167,25399400,3.428919e-12,193622758,7547768,667919028
2990000,27196503792,445089347,6.008706184500001e-11,193171092,-198090436,469828592
2995000,2045557000,25353609,3.4227372150000003e-12,192134546,7515836,477344428
3000000,2058902292,25388386,3.42743211e-12,193264800,7534952,484879380
3005000,2070773041,25344774,3.4215444900000005e-12,191847418,7499700,492379080
3010000,2075316542,25426268,3.4325461800000004e-12,194495982,7542596,499921676
3015000,2066616250,25523516,3.44567466e-12,197656535,7612460,507534136
3020000,2073011542,25737787,3.4746012450000006e-12,201232378,7681452,515215588
3025000,2054271500,25590720,3.4547472000000004e-12,199840647,7649048,522864636
3030000,2062433042,25609141,3.4572340350000006e-12,200439330,7670936,530535572
3035000,2063206208,25577774,3.45299949e-12,199419904,7648984,538184556
3040000,2066924958,25565675,3.4513661250000003e-12,199026691,7642376,545826932
3045000,2069975417,25726543,3.4730833050000005e-12,200866942,7676308,553503240
3050000,2067386750,25566460,3.4514721000000004e-12,199052198,7653812,561157052
3055000,2060296417,25563089,3.451017015e-12,198942656,7651396,568808448
3060000,2041156334,25623041,3.459110535e-12,200891092,7667732,576476180
3065000,2055661375,25554125,3.4498068750000004e-12,198651318,7628152,584104332
3070000,2065420416,25741326,3.47507901e-12,201347403,7679188,591783520
3075000,2066955625,25586360,3.4541586000000003e-12,199698960,7653232,599436752
3080000,2065047417,25582388,3.4536223800000004e-12,199569877,7652808,607089560
3085000,2071012250,25600978,3.4561320300000003e-12,200174042,7659072,614748632
3090000,2050391833,25578118,3.45304593e-12,199431087,7653972,622402604
3095000,2041210542,25724151,3.472760385e-12,200789211,7677868,630080472
3100000,2048604708,25580481,3.4533649350000006e-12,199507894,7645820,637726292
3105000,2076980667,25605556,3.4567500600000007e-12,200322819,7672748,645399040
3110000,2068619875,25596471,3.4555235850000003e-12,200027576,7664688,653063728
3115000,2067259000,25772107,3.4792344450000006e-12,202347796,7694332,660758060
3120000,2068059875,25621204,3.4588625400000002e-12,200831378,7649200,668407260
3125000,2042402125,25600709,3.4560957150000005e-12,200165301,7648068,676055328
3130000,2059494417,25415833,3.4311374550000002e-12,194156823,7511588,683566916
3135000,2051452125,25453376,3.4362057600000004e-12,195376968,7545636,691112552
3140000,2059522125,25585913,3.454098255e-12,196296472,7562048,698674600
3145000,27180434167,466894216,6.303071916e-11,194329825,-204486188,494188412
3150000,2062074875,25475381,3.4391764350000003e-12,196092142,7553868,501742280
3155000,2062496875,25560617,3.4506832950000004e-12,195311579,7547624,509289904
3160000,2070538208,25449285,3.435653475e-12,195244014,7530572,516820476
3165000,2067061709,25487088,3.4407568800000004e-12,196472616,7555820,524376296
3170000,2054541417,25450826,3.4358615100000004e-12,195294111,7537108,531913404
3175000,2041385334,25467270,3.4380814500000003e-12,195828530,7534676,539448080
3180000,2044666792,25372530,3.4252915500000003e-12,189198753,7413444,546861524
3185000,2047551750,25356200,3.4230870000000004e-12,192218770,7474980,554336504
3190000,2059294667,25416831,3.4312721850000003e-12,194189273,7495288,561831792
3195000,2058387583,25465568,3.4378516800000003e-12,195773232,7548848,569380640
3200000,2077403792,25415136,3.4310433600000003e-12,194134182,7505660,576886300
3205000,2067382750,25508196,3.44360646e-12,193607905,7507820,584394120
3210000,2067171917,25457219,3.4367245650000005e-12,195501886,7523360,591917480
3215000,2063654292,25476813,3.4393697550000002e-12,196138675,7542160,599459640
3220000,2045235750,25424001,3.4322401350000005e-12,194422291,7506308,606965948
3225000,2039067750,25418493,3.4314965550000007e-12,194243267,7519000,614484948
3230000,2063403042,25570109,3.4519647150000004e-12,195620067,7555288,622040236
3235000,2051368584,25416881,3.431278935e-12,194190902,7514244,629554480
3240000,2074775875,25466432,3.43796832e-12,195801292,7549316,637103796
3245000,2070835458,25449838,3.4357281300000003e-12,195262001,7539584,644643380
3250000,2064961000,25421995,3.4319693250000004e-12,194357101,7518900,652162280
3255000,2054703416,25598838,3.4558431300000004e-12,196553786,7562040,659724320
3260000,2066077458,25468329,3.4382244150000003e-12,195862953,7538120,667262440
3265000,2054519417,25474143,3.439009305e-12,196051902,7545696,674808136
3270000,4746968625,25518067,3.4449390450000005e-12,193928717,7502200,682310336
3275000,2050847959,25463520,3.4375752000000004e-12,195706657,7531688,689842024
3280000,2070214000,25423905,3.4322271750000006e-12,194419176,7543120,697385144
3285000,2046742958,25430043,3.4330558050000006e-12,194618648,7549816,704934960
3290000,2062179583,25494157,3.4417111950000003e-12,196702369,7596696,712531656
3295000,2070571500,25731174,3.4737084900000004e-12,200854687,7678300,720209956
3300000,2063036792,25563263,3.4510405050000003e-12,198948321,7633336,727843292
3305000,2066839875,25615753,3.4581266550000003e-12,200654238,7676684,735519976
3310000,27182142625,490260757,6.618520219500001e-11,199543535,-215405944,520114032
3315000,2065500042,25594912,3.45531312e-12,199976913,7661224,527775256
3320000,2077237750,25626137,3.4595284950000004e-12,200991699,7675504,535450760
3325000,2071091166,25566343,3.4514563050000004e-12,199048412,7635616,543086376
3330000,2068920750,25548882,3.4490990700000003e-12,198480922,7635212,550721588
3335000,2064010791,25539062,3.44777337e-12,198161795,7632032,558353620
3340000,2061002541,25554486,3.4498556100000004e-12,198663052,7645836,565999456
3345000,2079630625,25673148,3.4658749800000007e-12,198782817,7638252,573637708
3350000,2071342250,25516731,3.4447586850000005e-12,197436029,7617372,581255080
3355000,2069801500,25553730,3.4497535500000004e-12,198638476,7630760,588885840
3360000,2064669917,25558928,3.45045528e-12,198807436,7629420,596515260
3365000,2075624583,25581789,3.4535415150000006e-12,199550403,7637412,604152672
3370000,2057334458,25709519,3.4707850650000003e-12,199964868,7656492,611809164
3375000,2053658916,25606661,3.456899235e-12,200358750,7659444,619468608
3380000,2065512250,25550386,3.4493021100000003e-12,198529816,7640364,627108972
3385000,2081622125,25626808,3.4596190800000003e-12,201013533,7678688,634787660
3390000,2070107458,25570462,3.4520123700000003e-12,199182281,7646892,642434552
3395000,2062061708,25692835,3.4685327250000003e-12,199422633,7652516,650087068
3400000,2068415416,25561709,3.4508307150000005e-12,198897815,7635280,657722348
3405000,2070161208,25591995,3.4549193250000004e-12,199882111,7664716,665387064
3410000,2066776750,25622106,3.4589843100000004e-12,200860724,7673016,673060080
3415000,2060490791,25575894,3.4527456900000005e-12,199358823,7650524,680710604
3420000,2065869500,25546223,3.4487401050000004e-12,194657766,7545244,688255848
3425000,2072051917,25442225,3.434700375e-12,195014578,7564148,695819996
3430000,2064231500,25371921,3.4252093350000002e-12,192729703,7523848,703343844
3435000,2065703250,25372686,3.4253126100000004e-12,192754541,7528740,710872584
3440000,2067228042,25370208,3.4249780800000006e-12,192674027,7523340,718395924
3445000,2068617666,25489692,3.44110842e-12,192820493,7536928,725932852
3450000,2075984000,25423299,3.4321453650000005e-12,194399484,7559356,733492208
3455000,2061510625,25540129,3.447917415e-12,198196455,7630728,741122936
3460000,2069153333,25610872,3.4574677200000003e-12,200495589,7682784,748805720
3465000,2068351250,25616901,3.4582816350000003e-12,200691531,7673656,756479376
3470000,2066694625,25717922,3.4719194700000003e-12,200237970,7658164,764137540
3475000,2065536709,25560848,3.4507144800000003e-12,198869807,7641872,771779412
3480000,2070179125,25533219,3.446984565e-12,197971889,7637392,779416804
3485000,33402742709,514873598,6.950793573000001e-11,199746417,-231800916,547615888
3490000,2071702625,25679755,3.4667669250000004e-12,198786286,7641120,555257008
3495000,2072586584,25554711,3.4498859850000005e-12,198670385,7656856,562913864
3500000,2068088666,25549174,3.4491384900000002e-12,198490412,7647680,570561544
3505000,2063761750,25566062,3.4514183700000007e-12,199039294,7643424,578204968
3510000,2044942500,25591211,3.4548134850000004e-12,199856625,7669832,585874800
3515000,2063539917,25733907,3.4740774450000004e-12,200546245,7671704,593546504
3520000,2073385709,25553260,3.4496901000000005e-12,198623214,7638668,601185172
3525000,2058353792,25588978,3.45451203e-12,199784042,7657384,608842556
3530000,2049200542,25562459,3.450931965e-12,198922179,7648504,616491060
3535000,2060801167,25586118,3.4541259300000007e-12,199691114,7673976,624165036
3540000,2049867625,25732746,3.4739207100000003e-12,200508487,7683668,631848704
3545000,2051805708,25558667,3.4504200450000003e-12,198798937,7648184,639496888
3550000,2047301250,25578893,3.4531505550000002e-12,199456268,7661036,647157924
3555000,2049549708,25590222,3.4546799700000005e-12,199824457,7666976,654824900
3560000,2052652334,25540448,3.4479604800000003e-12,198206809,7621312,662446212
3565000,2054611875,25734258,3.4741248300000003e-12,200557629,7673516,670119728
3570000,2040891125,25760766,3.47770341e-12,205367147,7767908,677887636
3575000,2053973750,25689534,3.4680870900000003e-12,203052108,7719448,685607084
3580000,2060458084,25613494,3.4578216900000004e-12,200580807,7664656,693271740
3585000,2061016833,25583582,3.45378357e-12,199608686,7653552,700925292
3590000,2043774458,25718855,3.472045425e-12,200057062,7661312,708586604
3595000,2053420167,25560256,3.4506345600000005e-12,198850579,7643472,716230076
3600000,2062048250,25571532,3.4521568200000005e-12,199217049,7639924,723870000
3605000,2060762250,25647629,3.462429915e-12,201690197,7678676,731548676
3610000,2059955875,25607596,3.4570254600000006e-12,200389137,7660076,739208752
3615000,2044375875,25749431,3.476173185e-12,201050766,7665764,746874516
3620000,2061276250,25616018,3.4581624300000007e-12,200662831,7647456,754521972
3625000,2058621750,25448423,3.4355371050000003e-12,195216010,7536028,762058000
3630000,2058387500,25435146,3.4337447100000006e-12,194784497,7541856,769599856
3635000,2061128291,25463782,3.4376105700000004e-12,195715178,7562300,777162156
3640000,2052037625,25555068,3.4499341800000003e-12,194733975,7537568,784699724
3645000,2058628875,25468810,3.4382893500000003e-12,195878582,7552984,792252708
3650000,2060109125,25431710,3.43328085e-12,194672835,7531968,799784676
3655000,2059653375,25475483,3.439190205e-12,196095460,7569224,807353900
3660000,2060944333,25415607,3.4311069450000003e-12,194149500,7518092,814871992
3665000,33386256958,540096905,7.291308217500002e-11,196358799,-238971680,575900312
3670000,2052598625,25568464,3.4517426400000002e-12,194981194,7536560,583436872
3675000,2058313084,25450718,3.4358469300000002e-12,195290600,7546224,590983096
3680000,2034999334,25463403,3.4375594050000004e-12,195702858,7557956,598541052
3685000,2053497917,25398022,3.4287329700000003e-12,193577994,7512892,606053944
3690000,2051644625,25431003,3.4331854050000003e-12,194649876,7537660,613591604
3695000,2060677125,25549548,3.4491889800000002e-12,194366410,7527520,621119124
3700000,2058224333,25427106,3.4326593100000005e-12,194523215,7530056,628649180
3705000,2056621875,25441298,3.4345752300000004e-12,194984441,7531604,636180784
3710000,2046063250,25252479,3.4090846650000004e-12,188847844,7391684,643572468
3715000,2065161167,25248554,3.4085547900000003e-12,188720253,7397580,650970048
3720000,2059705959,25446762,3.4353128700000004e-12,191025872,7435508,658405556
3725000,2056034084,25250726,3.40884801e-12,188790852,7403472,665809028
3730000,2059477041,25294733,3.4147889550000003e-12,190221072,7431568,673240596
3735000,2046672375,25389260,3.4275501e-12,193293211,7499612,680740208
3740000,2064620583,25465907,3.4378974450000004e-12,195784248,7553688,688293896
3745000,2056578250,25565150,3.45129525e-12,194873487,7528492,695822388
3750000,2067020416,25441808,3.4346440800000006e-12,195001029,7527940,703350328
3755000,2057829417,25493980,3.4416873000000005e-12,196696622,7558288,710908616
3760000,2043374875,25410368,3.4303996800000005e-12,193979218,7511172,718419788
3765000,2041949167,25574302,3.4525307700000002e-12,195170944,7539544,725959332
3770000,2059650250,25465946,3.43790271e-12,195785491,7542164,733501496
3775000,2061996959,25470854,3.4385652900000004e-12,195944997,7544100,741045596
3780000,2063126958,25391139,3.427803765e-12,193354284,7501084,748546680
3785000,2071743416,25465346,3.4378217100000007e-12,195766024,7561016,756107696
3790000,2058512542,25543064,3.4483136400000003e-12,194155689,7528000,763635696
3795000,2040650167,25436113,3.4338752550000002e-12,194815939,7526744,771162440
3800000,2046967833,25448847,3.4355943450000006e-12,195229801,7538416,778700856
3805000,2045876417,25408190,3.4301056500000005e-12,193908438,7510700,786211556
3810000,2039008500,25414336,3.43093536e-12,194108192,7516120,793727676
3815000,2054568000,25602710,3.4563658500000006e-12,196094202,7549236,801276912
3820000,2076504375,25432567,3.4333965450000005e-12,194700678,7526128,808803040
3825000,2048636167,25481631,3.4400201850000003e-12,196295270,7550264,816353304
3830000,2066378458,25402128,3.42928728e-12,193711427,7519224,823872528
3835000,2065392292,25450729,3.4358484150000004e-12,195290942,7550720,831423248
3840000,2047017375,25540870,3.4480174500000006e-12,194084384,7531976,838955224
3845000,2044356792,25418094,3.4314426900000004e-12,194230300,7534236,846489460
3850000,2038526750,25470791,3.4385567850000005e-12,195942976,7562640,854052100
3855000,2068181542,25406706,3.4299053100000005e-12,193860190,7506312,861558412
3860000,40854935750,567571069,7.6622094315e-11,194963137,-255024080,606534332
3865000,2054010917,25232810,3.4064293500000005e-12,188208583,7384448,613918780
3870000,2046145625,25294513,3.414759255e-12,190213926,7437848,621356628
3875000,2044510458,25234736,3.4066893600000004e-12,188271173,7395428,628752056
3880000,2045168875,25287882,3.4138640700000002e-12,189998438,7439216,636191272
3885000,2039568917,25216770,3.4042639500000005e-12,187687302,7405328,643596600
3890000,2038549333,25266216,3.41093916e-12,189294282,7431312,651027912
3895000,2071360917,25226434,3.4055685900000007e-12,188001347,7395272,658423184
3900000,2051049208,25355036,3.4229298600000002e-12,187816312,7401628,665824812
3905000,2059729583,25290512,3.41421912e-12,190083909,7440724,673265536
3910000,2040384334,25353670,3.4227454500000003e-12,192136550,7473228,680738764
3915000,2036049875,25481553,3.440009655e-12,196292739,7554960,688293724
3920000,2045861292,25428696,3.43287396e-12,194574895,7518452,695812176
3925000,2105009250,25604899,3.4566613650000002e-12,195936872,7558604,703370780
3930000,3080585875,25455974,3.4365564900000004e-12,195461403,7557660,710928440
3935000,2061740167,25402266,3.42930591e-12,193715919,7524888,718453328
3940000,2053277042,25452744,3.4361204400000003e-12,195356448,7567496,726020824
3945000,2058632750,25531342,3.4467311700000006e-12,193546256,7533204,733554028
3950000,2058648333,25428062,3.4327883700000004e-12,194554287,7552232,741106260
3955000,2049277834,25439099,3.434278365e-12,194912970,7531680,748637940
3960000,2058976084,25429038,3.43292013e-12,194585986,7527004,756164944
3965000,2059880416,25404895,3.4296608250000006e-12,193801343,7517912,763682856
3970000,2055685042,25579294,3.4532046900000005e-12,195104691,7534792,771217648
3975000,2039684750,25416621,3.4312438350000005e-12,194182456,7529504,778747152
3980000,2055189875,25423415,3.4321610250000004e-12,194403245,7547020,786294172
3985000,2054877125,25436860,3.4339761e-12,194840210,7547352,793841524
3990000,2034524375,25404634,3.42962559e-12,193792881,7532880,801374404
3995000,2058284333,25561278,3.4507725300000003e-12,194519159,7538432,808912836
4000000,2064744083,25383290,3.4267441500000004e-12,193099188,7512860,816425696
4005000,2065605584,25453902,3.4362767700000003e-12,195394082,7555848,823981544
4010000,2068488917,25414933,3.4310159550000004e-12,194127590,7515812,831497356
4015000,2067345416,25390234,3.4276815900000002e-12,193324858,7502820,839000176
4020000,2070509875,25436710,3.43395585e-12,190470734,7433308,846433484
4025000,2069461208,25280918,3.41292393e-12,189772089,7416240,853849724
4030000,2065668833,25237742,3.4070951700000005e-12,188368884,7404848,861254572
4035000,2064474875,25288270,3.41391645e-12,190011022,7436628,868691200
4040000,2067047666,25236771,3.4069640850000003e-12,188337328,7404780,876095980
4045000,2062936000,25398894,3.42885069e-12,189241683,7423096,883519076
4050000,2048573875,25287515,3.413814525e-12,189986513,7428556,890947632
4055000,2071196500,25347654,3.4219332900000003e-12,191941032,7480492,898428124
4060000,2067117291,25488994,3.44101419e-12,196534552,7560912,905989036
4065000,33391794083,596164960,8.048226960000001e-11,193646372,-267244208,638744828
4070000,2048919750,25469693,3.4384085550000003e-12,195907291,7558492,646303320
4075000,2058534000,25580464,3.4533626400000004e-12,194916174,7534652,653837972
4080000,2049119000,25403083,3.4294162050000002e-12,193742468,7520932,661358904
4085000,2061712292,25452917,3.4361437950000003e-12,195362074,7550884,668909788
4090000,2060118250,25411506,3.43055331e-12,194016219,7517428,676427216
4095000,2061212083,25460705,3.4371951750000004e-12,195615175,7556600,683983816
4100000,2063978000,25567569,3.4516218150000003e-12,194497085,7533004,691516820
4105000,2052638167,25482131,3.440087685e-12,196311515,7555588,699072408
4110000,2058984583,25488913,3.4410032550000005e-12,196531938,7547972,706620380
4115000,2057750792,25418696,3.4315239600000007e-12,194249876,7514588,714134968
4120000,2047372167,25388369,3.4274298150000003e-12,193264247,7498588,721633556
4125000,2057877750,25643469,3.4618683150000002e-12,196963815,7570324,729203880
4130000,2061386000,25421786,3.4319411100000003e-12,194350307,7519300,736723180
4135000,2059937459,25426292,3.4325494200000006e-12,194496764,7526908,744250088
4140000,2042828958,25441576,3.4346127600000005e-12,194993470,7534512,751784600
4145000,2058402167,25558874,3.4504479900000005e-12,194214501,7525436,759310036
4150000,2060243125,25436313,3.4339022550000005e-12,194822419,7528948,766838984
4155000,2042792834,25413121,3.4307713350000004e-12,194068677,7513064,774352048
4160000,2051286375,25482810,3.4401793500000004e-12,196333567,7559004,781911052
4165000,2052439958,25442357,3.4347181950000005e-12,195018866,7536276,789447328
4170000,2068115458,25619013,3.4585667550000007e-12,196168993,7557572,797004900
4175000,2052673750,25443386,3.43485711e-12,195052322,7534640,804539540
4180000,2046521583,25380516,3.4263696600000004e-12,193009031,7496988,812036528
4185000,2065724000,25298380,3.4152813000000003e-12,190339609,7442840,819479368
4190000,2067765417,25358094,3.4233426900000005e-12,192280299,7486324,826965692
4195000,2060355542,25572675,3.4523111250000005e-12,194663033,7524740,834490432
4200000,2070290667,25428525,3.4328508750000004e-12,194569321,7529664,842020096
4205000,2064763166,25376956,3.4258890600000004e-12,192893340,7511280,849531376
4210000,2065547542,25464200,3.437667e-12,195728758,7546992,857078368
4215000,2065723458,25390708,3.4277455800000003e-12,193340268,7502280,864580648
4220000,2046914083,25435260,3.4337601e-12,190197029,7430804,872011452
4225000,2065817250,25248353,3.4085276550000003e-12,188713742,7406112,879417564
4230000,2064611834,25292191,3.4144457850000003e-12,190138467,7443464,886861028
4235000,2071880208,25393169,3.4280778150000003e-12,193420255,7506624,894367652
4240000,2073413833,25415641,3.431111535e-12,194150581,7521328,901888980
4245000,2048926833,25613173,3.457778355e-12,195979209,7561804,909450784
4250000,2072482708,25447860,3.4354611000000002e-12,195197703,7543760,916994544
4255000,2068416834,25458676,3.4369212600000003e-12,195549222,7555412,924549956
4260000,2071259042,25480145,3.4398195750000003e-12,196246984,7557076,932107032
4265000,2068084875,25434891,3.4337102850000006e-12,194776218,7526076,939633108
4270000,2039892958,25525916,3.44599866e-12,193143355,7486940,947120048
4275000,2062442583,25485685,3.440567475e-12,196427025,7553604,954673652
4280000,40842481208,626464205,8.4572667675e-11,193170491,-282132240,672541412
4285000,2062920500,25450693,3.4358435550000007e-12,195289795,7551604,680093016
4290000,2046426750,25454772,3.4363942200000002e-12,195422345,7557464,687650480
4295000,2048237583,25381845,3.426549075e-12,193052234,7505732,695156212
4300000,2060350959,25601083,3.456146205e-12,195342307,7549820,702706032
4305000,2056832917,25403743,3.4295053050000004e-12,193763919,7510892,710216924
4310000,2059714959,25445808,3.43518408e-12,195131020,7540752,717757676
4315000,2055346958,25421109,3.4318497150000007e-12,194328311,7526780,725284456
4320000,2049266167,25410638,3.43043613e-12,193988016,7517824,732802280
4325000,2054107500,25612969,3.4577508150000007e-12,195728616,7548884,740351164
4330000,2059507166,25310880,3.4169688000000002e-12,190745862,7465916,747817080
4335000,2061280334,25277010,3.41239635e-12,189645090,7430552,755247632
4340000,2040716208,25351599,3.422465865e-12,192069224,7484268,762731900
4345000,2039438042,25472170,3.43874295e-12,195987792,7561708,770293608
4350000,2057506542,25417011,3.4312964850000002e-12,189359947,7436052,777729660
4355000,2061288292,25263500,3.4105725000000003e-12,189206004,7430856,785160516
4360000,2037183250,25269929,3.4114404150000004e-12,189414962,7417628,792578144
4365000,2050549709,25270068,3.4114591800000003e-12,189419461,7412712,799990856
4370000,2040837625,25275912,3.4122481200000004e-12,189609407,7423424,807414280
4375000,2039101125,25633300,3.4604955000000003e-12,196389346,7560072,814974352
4380000,2054620083,25404644,3.4296269400000004e-12,193793202,7517760,822492112
4385000,2036743291,25471654,3.4386732900000005e-12,195971016,7563456,830055568
4390000,2046799708,25440316,3.43444266e-12,194952520,7536104,837591672
4395000,2046794458,25428798,3.4328877300000005e-12,194578183,7530876,845122548
4400000,2049279916,25607988,3.45707838e-12,195566732,7551624,852674172
4405000,2034632667,25425356,3.4324230600000007e-12,194466334,7531620,860205792
4410000,2049260667,25459510,3.4370338500000006e-12,195576328,7544204,867749996
4415000,2060220042,25394990,3.4283236500000006e-12,193479447,7508636,875258632
4420000,2042752792,25485455,3.4405364250000006e-12,196419545,7564324,882822956
4425000,2054474166,25567858,3.45166083e-12,194262490,7520900,890343856
4430000,2059151333,25450744,3.4358504400000003e-12,195291452,7559488,897903344
4435000,2061221042,25419964,3.4316951400000004e-12,194291077,7536888,905440232
4440000,2057986667,25441341,3.4345810350000004e-12,194985827,7557664,912997896
4445000,2037130459,25454581,3.4363684350000002e-12,195416147,7551028,920548924
4450000,2040230625,25597407,3.4556499450000003e-12,195222821,7552244,928101168
4455000,2056947125,25378213,3.4260587550000008e-12,192934187,7499872,935601040
4460000,2036894458,25470031,3.4384541850000002e-12,195918257,7556820,943157860
4465000,2051630875,25428179,3.4328041650000004e-12,194558070,7534504,950692364
4470000,2043869416,25448732,3.4355788200000005e-12,195226055,7545712,958238076
4475000,2054094083,25561264,3.45077064e-12,194048195,7522312,965760388
4480000,2039431916,25447294,3.43538469e-12,195179305,7565564,973325952
4485000,2048192292,25433430,3.43351305e-12,194728756,7544768,980870720
4490000,2051046459,25345961,3.4217047350000006e-12,191885979,7485996,988356716
4495000,2041770042,25240279,3.4074376650000005e-12,188451333,7413268,995769984
4500000,2050335667,25367759,3.4246474650000004e-12,187759280,7397340,1003167324
