Size,Time,Cycles,Price,Instructions,HeapSize,TotalHeapSize
5000,2977436500,17570657,2.372038695e-12,95279504,764196,765292
10000,2152666708,19370868,2.61506718e-12,106964750,785720,1551012
15000,2202872250,20196326,2.7265040099999997e-12,111904950,786052,2337064
20000,2318259541,20992776,2.83402476e-12,115879705,787504,3124568
25000,2252788792,21823216,2.9461341599999997e-12,121022696,783796,3908364
30000,2845119584,22472208,3.03374808e-12,120193638,785624,4693988
35000,2156697541,23192589,3.130999515e-12,121784864,784924,5478912
40000,2420607083,23986642,3.2381966700000003e-12,125750312,783560,6262472
45000,2244293166,24670039,3.330455265e-12,126013142,786236,7048708
50000,2578380458,18631921,2.5153093350000002e-12,126599937,4488068,11536776
55000,2147713542,27081736,3.65603436e-12,135681527,-2914840,8621936
60000,2081267000,19676303,2.6563009050000003e-12,135564836,4639284,13261220
65000,2233685084,28416920,3.8362842e-12,135248785,-3069064,10192156
70000,2198133083,19618554,2.64850479e-12,133688021,4593120,14785276
75000,2301942875,29761400,4.017789e-12,135272400,-3021536,11763740
80000,2833890541,19617858,2.6484108300000003e-12,133665398,4594456,16358196
85000,2064896875,31106481,4.199374935000001e-12,135132825,-3023812,13334384
90000,2907293167,19613379,2.6478061650000003e-12,133519814,4596588,17930972
95000,2246588792,32502669,4.387860315e-12,136868603,-3025664,14905308
100000,2179727500,19628501,2.649847635e-12,134011281,4603964,19509272
105000,2209074084,33844202,4.56896727e-12,136715722,-3032852,16476420
110000,2129502625,19780212,2.67032862e-12,138941906,4728068,21204488
115000,2088310125,35275577,4.762202895e-12,139482588,-3156956,18047532
120000,2974001291,19842941,2.6787970350000002e-12,140843086,4766108,22813640
125000,2213755375,19810108,2.67436458e-12,139913535,4742384,27556024
130000,2288413750,37339018,5.04076743e-12,140891423,-7150580,20405444
135000,2290862208,19782171,2.670593085e-12,139005550,4718680,25124124
140000,2108820542,19857129,2.6807124150000003e-12,141278435,4770860,29894984
145000,2255315709,39300785,5.3056059750000006e-12,139080743,-7136276,22758708
150000,2261197583,19821124,2.6758517400000003e-12,140271534,4749400,27508108
155000,2209602375,19881457,2.683996695e-12,142055330,4767952,32276060
160000,2275265083,41341268,5.58107118e-12,139692971,-7156480,25119580
165000,2284331000,19782365,2.6706192749999998e-12,139011870,4728312,29847892
170000,2057811583,19824049,2.676246615e-12,140366609,4752608,34600500
175000,2059285917,43336902,5.850481770000001e-12,138673766,-7121080,27479420
180000,2469376750,19834062,2.67759837e-12,140692007,4761204,32240624
185000,2221614416,19758649,2.667417615e-12,138241099,4699596,36940220
190000,2574233875,19853406,2.68020981e-12,141115768,4770940,41711160
195000,2159296208,46030844,6.2141639400000004e-12,138947505,-11091584,30619576
200000,2085820333,19852384,2.68007184e-12,141287505,4772552,35392128
205000,2273328750,19987895,2.698365825e-12,145691576,4859808,40251936
210000,2228964708,19949964,2.6932451400000004e-12,144223484,4851868,45103804
215000,2431742708,48942206,6.6071978099999996e-12,146076329,-11342664,33761140
220000,2338392417,19940441,2.6919595350000004e-12,144149346,4846028,38607168
225000,2502665334,19992346,2.6989667100000004e-12,145581132,4875052,43482220
230000,2221412875,20005424,2.7007322400000003e-12,146261300,4883444,48365664
235000,2354377333,51598355,6.965777925e-12,144854547,-11459860,36905804
240000,2041606250,19999900,2.6999865e-12,146081773,4890672,41796476
245000,2329686750,19960823,2.694711105e-12,144537864,4850144,46646620
250000,2386429959,19974805,2.696598675e-12,145266177,4872988,51519608
255000,2222582667,19993519,2.699125065e-12,145874356,4868596,56388204
260000,3295316042,55009531,7.426286685000001e-12,146064061,-15556852,40831352
265000,2293387834,19951213,2.693413755e-12,144499441,4852052,45683404
270000,2675541750,19996716,2.69955666e-12,145978275,4886232,50569636
275000,2095509000,19960510,2.69466885e-12,144801582,4851900,55421536
280000,3226045833,19999023,2.699868105e-12,145743865,4873668,60295204
285000,3575783208,58366702,7.87950477e-12,146104020,-15536144,44759060
290000,2192303959,19954455,2.693851425e-12,144604813,4853704,49612764
295000,2206473125,20014258,2.7019248299999997e-12,146215964,4889012,54501776
300000,2794795834,19958486,2.69439561e-12,144735796,4852000,59353776
305000,2224133500,20013291,2.701794285e-12,146516947,4881732,64235508
310000,3913056125,61889041,8.355020535000001e-12,150854631,-15549304,48686204
315000,2103495041,20177823,2.7240061050000002e-12,151864257,5077488,53763692
320000,2746881625,20289230,2.73904605e-12,155484985,5194508,58958200
325000,2073641458,20234753,2.731691655e-12,153714476,5149700,64107900
330000,2044121916,20268753,2.736281655e-12,154819475,5177848,69285748
335000,3292620167,65344965,8.821570275e-12,154146455,-16671696,52614052
340000,2322339750,20255557,2.734500195e-12,154390625,5166360,57780412
345000,2176674875,20298880,2.7403488e-12,155798601,5193172,62973584
350000,2212518833,20240003,2.732400405e-12,153501905,5149356,68122940
355000,2063489834,20316563,2.742736005e-12,156373286,5189100,73312040
360000,2491548416,20180882,2.7244190700000002e-12,151963667,5102176,78414216
365000,3298745375,69430180,9.3730743e-12,155178431,-21083776,57330440
370000,2566843875,20273710,2.7369508500000005e-12,154980573,5178248,62508688
375000,2111371250,20248282,2.73351807e-12,154154181,5164372,67673060
380000,2835964459,20281952,2.73806352e-12,155248456,5185876,72858936
385000,2206883292,20243788,2.73291138e-12,153584006,5141152,78000088
390000,2363413292,20264167,2.735662545e-12,154670454,5172192,83172280
395000,3308976083,73480966,9.919930410000001e-12,156033874,-21130388,62041892
400000,2838471709,20258076,2.73484026e-12,154020260,5147320,67189212
405000,2207100084,20293963,2.7396850049999998e-12,155638819,5178320,72367532
410000,2673005209,20146798,2.7198177299999998e-12,150855944,5070152,77437684
415000,2184759625,20112446,2.71518021e-12,149739501,5045064,82482748
420000,2656353666,20156144,2.72107944e-12,150707477,5062052,87544800
425000,2160083916,20116770,2.71576395e-12,149880024,5039096,92583896
430000,4422928917,78030907,1.0534172445000001e-11,150756713,-25042200,67541696
435000,2032165958,20139993,2.718899055e-12,150634789,5060100,72601796
440000,2575633167,20121865,2.7164517750000004e-12,149549597,5035756,77637552
445000,2213260334,20137543,2.7185683050000003e-12,150555154,5055940,82693492
450000,2093963333,20230674,2.7311409899999997e-12,153581910,5127704,87821196
455000,3191151459,20281192,2.73796092e-12,154727728,5144844,92966040
460000,2214162000,20096317,2.713002795e-12,149215317,5027224,97993264
465000,6015678167,82687148,1.1162764979999999e-11,148378345,-24950024,73043240
470000,2198714416,20100595,2.713580325e-12,149354337,5032940,78076180
475000,2378380000,20096862,2.71307637e-12,149233022,5023556,83099736
480000,2181806000,20066691,2.7090032850000002e-12,147724513,4993408,88093144
485000,2238710667,20109963,2.714845005e-12,149658812,5026820,93119964
490000,2673180334,20078056,2.7105375599999998e-12,148621834,5005584,98125548
495000,2166453833,20106634,2.71439559e-12,149550616,5025688,103151236
500000,2286967000,20124432,2.71679832e-12,149601082,5029228,108180464
505000,3618623834,89150550,1.203532425e-11,158999039,-28852400,79328064
510000,2419009708,21145420,2.8546317e-12,158363672,5161904,84489968
515000,2244515542,21260793,2.8702070550000003e-12,161536086,5234032,89724000
520000,2252560167,21316861,2.8777762350000002e-12,163935496,5287484,95011484
525000,2257095833,21298676,2.87532126e-12,163344507,5275004,100286488
530000,2554644083,21343678,2.8813965299999997e-12,164807072,5314928,105601416
535000,2286256709,21310729,2.876948415e-12,163159037,5285072,110886488
540000,2398512458,21308938,2.87670663e-12,163678015,5297504,116183992
545000,4780451334,94701232,1.278466632e-11,164346362,-30568996,85614996
550000,3184840500,21291206,2.8743128099999998e-12,162481905,5274292,90889288
555000,2035393166,21321895,2.8784558250000003e-12,164099111,5292292,96181580
560000,2281855375,21318014,2.8779318900000002e-12,163972996,5304120,101485700
565000,2267666750,21318200,2.877957e-12,163359181,5291396,106777096
570000,2522388417,21312792,2.8772269200000003e-12,163803269,5307172,112084268
575000,2168550750,21285764,2.8735781400000004e-12,162924855,5288912,117373180
580000,2400616333,21313436,2.8773138600000003e-12,163824210,5300164,122673344
585000,2259538334,21301068,2.87564418e-12,163422231,5290708,127964052
590000,4745528208,100765166,1.360329741e-11,164537515,-35279216,92684836
595000,2252592459,21317717,2.877891795e-12,163287682,5293640,97978476
600000,2296318791,21284273,2.873376855e-12,162876391,5285496,103263972
605000,2292179667,21305131,2.8761926849999997e-12,163554282,5286564,108550536
610000,3696418041,21286882,2.8737290699999997e-12,162285545,5277540,113828076
615000,2257653458,21268933,2.871305955e-12,162377865,5281500,119109576
620000,2655461125,21317700,2.8778895e-12,163962773,5319652,124429228
625000,2102370791,21271545,2.871658575e-12,162462744,5283260,129712488
630000,2470187917,21290085,2.874161475e-12,162389638,5280468,134992956
635000,6772803375,106799485,1.4417930475e-11,163792430,-35239456,99753500
640000,2168298416,21168676,2.85777126e-12,158402184,5181892,104935392
645000,3136703000,21175561,2.858700735e-12,159343268,5200032,110135424
650000,2259111375,21120844,2.85131394e-12,157564966,5154756,115290180
655000,3456969416,21138556,2.85370506e-12,158140609,5161532,120451712
660000,2105919083,21150657,2.8553386949999996e-12,158533905,5186312,125638024
665000,2310730750,21166436,2.8574688599999998e-12,159046692,5201228,130839252
670000,2226158250,21315261,2.8775602350000003e-12,163883517,5299872,136139124
675000,2332808458,21197336,2.86164036e-12,159333652,5204800,141343924
680000,2261987292,21153183,2.8556797050000003e-12,158615981,5188620,146532544
685000,5821959000,113510263,1.5323885505e-11,162338367,-38922640,107609904
690000,2326737167,21298327,2.875274145e-12,163333157,5289716,112899620
695000,2073028000,21329834,2.87952759e-12,164357140,5308244,118207864
700000,2102107167,21296096,2.8749729600000004e-12,163260660,5283284,123491148
705000,3349080750,21373801,2.885463135e-12,165011595,5296888,128788036
710000,2158338750,21266807,2.8710189450000004e-12,162308755,5270236,134058272
715000,3607878667,21300304,2.8755410399999998e-12,163397413,5297492,139355764
720000,2299213625,21353403,2.882709405e-12,164348674,5318292,144674056
725000,2283447667,21282765,2.873173275e-12,162827403,5277312,149951368
730000,2342638167,21290548,2.87422398e-12,163080332,5287392,155238760
735000,2310649417,21324671,2.878830585e-12,164189328,5316984,160555744
740000,6539742541,120886749,1.6319711115e-11,162160047,-44302024,116253720
745000,2398631625,21318268,2.87796618e-12,163981241,5308468,121562188
750000,2136562000,21321341,2.878381035e-12,163239595,5288288,126850476
755000,2795502834,21320034,2.87820459e-12,164038650,5297652,132148128
760000,2118896750,21330179,2.879574165e-12,164368365,5311568,137459696
765000,2121733166,21309562,2.8767908699999998e-12,162856785,5281724,142741420
770000,3488858958,21324953,2.878868655e-12,164198496,5302020,148043440
775000,2298560042,21282129,2.8730874150000003e-12,162806706,5274356,153317796
780000,2078351083,21358146,2.8833497099999997e-12,164435767,5307924,158625720
785000,3493966459,21276497,2.872327095e-12,162623681,5272172,163897892
790000,2266600625,21293977,2.8746868949999997e-12,163191768,5287240,169185132
795000,2390520750,21353593,2.882735055e-12,164287783,5313416,174498548
800000,6648968166,128995739,1.7414424765e-11,163082674,-48812240,125686308
805000,2136222584,21394776,2.88829476e-12,165557046,5312192,130998500
810000,2961798292,21289645,2.874102075e-12,163050992,5289992,136288492
815000,2269411500,21307545,2.8765185750000003e-12,163632732,5300988,141589480
820000,2282651417,21302332,2.87581482e-12,163463328,5297916,146887396
825000,2199999458,21353903,2.8827769050000004e-12,164228655,5315296,152202692
830000,2615398333,21318216,2.87795916e-12,163979561,5310440,157513132
835000,2145574000,21343064,2.88131364e-12,164787117,5317516,162830648
840000,3252592125,21401918,2.88925893e-12,166699878,5364760,168195408
845000,2582981917,21512746,2.90422071e-12,169391072,5425332,173620740
850000,2252453292,21481750,2.90003625e-12,169294420,5421384,179042124
855000,2436949958,21496116,2.90197566e-12,169761293,5411956,184454080
860000,6948345709,137271939,1.8531711765e-11,168634265,-49344388,135109692
865000,2385015375,21438733,2.894228955e-12,167896374,5400100,140509792
870000,2217077125,21524781,2.905845435e-12,169724458,5431528,145941320
875000,3149099708,21453630,2.8962400500000002e-12,168380499,5402632,151343952
880000,2247763375,21498005,2.902230675e-12,169822703,5431280,156775232
885000,2263650375,21440945,2.894527575e-12,167968239,5391540,162166772
890000,2180254833,21514874,2.90450799e-12,169402466,5425788,167592560
895000,2044092875,21457857,2.896810695e-12,168517877,5404548,172997108
900000,2307743250,21501845,2.9027490749999998e-12,169947501,5435368,178432476
905000,2420671708,21473199,2.898881865e-12,169016489,5397168,183829644
910000,2257604458,21441017,2.894537295e-12,167970596,5399540,189229184
915000,3267069417,21462239,2.8974022649999998e-12,168660297,5412780,194641964
920000,2448914125,21483311,2.9002469850000002e-12,169345142,5434700,200076664
925000,8729956292,146019083,1.9712576205e-11,168495473,-54757816,145318848
930000,2388662959,21494968,2.9018206799999997e-12,168679178,5416164,150735012
935000,2626308167,21478987,2.899663245e-12,169204615,5424492,156159504
940000,2042913625,21477396,2.89944846e-12,169152901,5416556,161576060
945000,2407852417,21495004,2.9018255399999997e-12,169725161,5424000,167000060
950000,2290554625,21329845,2.8795290750000002e-12,164357505,5308164,172308224
955000,2333627292,21344424,2.88149724e-12,164831310,5317512,177625736
960000,2239956791,21266220,2.8709397e-12,162289695,5281712,182907448
965000,2752191875,21294616,2.8747731599999998e-12,162167727,5280996,188188444
970000,2261900500,21312425,2.877177375e-12,163791343,5307004,193495448
975000,2449296000,21340051,2.880906885e-12,164689199,5334112,198829560
980000,2323563791,21481589,2.900014515e-12,169289186,5437984,204267544
985000,2337865084,21462266,2.89740591e-12,167616374,5399488,209667032
990000,2150164250,21475550,2.89919925e-12,169092916,5434560,215101592
995000,11781952000,155408435,2.0980138725e-11,167325810,-58786320,156315272
1000000,2047064083,21429698,2.8930092300000002e-12,167602713,5395888,161711160
1005000,2102570541,21504943,2.903167305e-12,168926433,5430388,167141548
1010000,2229477083,21459665,2.897054775e-12,168576645,5421428,172562976
1015000,2227877125,21417768,2.89139868e-12,167214976,5373832,177936808
1020000,3127774666,21541209,2.908063215e-12,170105080,5436384,183373192
1025000,2135759666,21459418,2.89702143e-12,168568620,5399052,188772244
1030000,2323942792,21445893,2.8951955549999997e-12,168129062,5405508,194177752
1035000,2270346500,21437682,2.89408707e-12,167862194,5398988,199576740
1040000,2284955709,21486009,2.9006112150000003e-12,168311098,5410664,204987404
1045000,2953245541,21467765,2.898148275e-12,168839884,5421260,210408664
1050000,2193664500,21433585,2.8935339750000004e-12,167729061,5394364,215803028
1055000,2288381708,21493083,2.9015662049999998e-12,169662732,5411500,221214528
1060000,2196978292,21476432,2.8993183200000002e-12,169121568,5428608,226643136
1065000,2315021125,21452685,2.896112475e-12,168349779,5412360,232055496
1070000,8923106542,165512671,2.2344210585e-11,168721357,-63958556,168096940
1075000,3254768291,21492268,2.9014561799999997e-12,168429613,5409980,173506920
1080000,2813691667,21512844,2.90423394e-12,169098354,5419628,178926548
1085000,2131043000,21473729,2.8989534149999998e-12,169033709,5424288,184350836
1090000,2780122375,21471709,2.898680715e-12,168968079,5417708,189768544
1095000,2918310833,21464249,2.897673615e-12,168725614,5417616,195186160
1100000,3429303292,21513832,2.90436732e-12,169130430,5415052,200601212
1105000,2332004583,21475968,2.8992556799999997e-12,169106483,5409796,206011008
1110000,2082863292,21472714,2.89881639e-12,169000739,5428240,211439248
1115000,2283647542,21306205,2.876337675e-12,163589178,5307068,216746316
1120000,2149077750,21308346,2.87662671e-12,163658792,5308912,222055228
1125000,2278580541,21390172,2.88767322e-12,166318106,5364304,227419532
1130000,2046084208,21531582,2.9067635700000002e-12,169707314,5440060,232859592
1135000,2264698250,21436383,2.893911705e-12,167819975,5389460,238249052
1140000,2294173583,21490838,2.9012631299999997e-12,169589780,5429292,243678344
1145000,2117802209,21476467,2.899323045e-12,169122720,5408084,249086428
1150000,9848754375,176261499,2.3795302364999998e-11,166850118,-68426836,180659592
1155000,2052701625,21374965,2.8856202749999997e-12,164529885,5303872,185963464
1160000,2279327833,21297894,2.8752156899999998e-12,163319082,5293332,191256796
1165000,2127321209,21255740,2.8695249e-12,161949081,5258432,196515228
1170000,6238040833,21372789,2.885326515e-12,164459137,5316484,201831712
1175000,2413288459,21415687,2.891117745e-12,167147360,5375168,207206880
1180000,2393800416,21506454,2.90337129e-12,170097285,5440160,212647040
1185000,2165733042,21448173,2.8955033549999997e-12,168203140,5393248,218040288
1190000,2250331125,21495038,2.90183013e-12,168432253,5403204,223443492
1195000,2240536417,21467791,2.8981517850000004e-12,168840745,5410208,228853700
1200000,4136709750,21410526,2.89042101e-12,166979640,5370240,234223940
1205000,2131513333,21542789,2.908276515e-12,169984172,5430932,239654872
1210000,2427243708,21449640,2.8957014e-12,168250820,5409152,245064024
1215000,2235463750,21489452,2.90107602e-12,169544724,5437636,250501660
1220000,2675726958,21470317,2.898492795e-12,168922824,5417404,255919064
1225000,2206948000,21514897,2.904511095e-12,169077650,5426580,261345644
1230000,2776746750,21474957,2.8991191950000004e-12,169073636,5429988,266775632
1235000,8931328625,187740818,2.534501043e-11,167982365,-72764056,194011576
1240000,2374893584,21484916,2.90046366e-12,169397303,5437620,199449196
1245000,2067791333,21466581,2.897988435e-12,168801416,5424388,204873584
1250000,2289174708,21440178,2.8944240300000002e-12,167943335,5404924,210278508
1255000,4729253125,21404707,2.889635445e-12,166790516,5360640,215639148
1260000,2277228416,21460762,2.89720287e-12,168612294,5415984,221055132
1265000,2043410959,21424711,2.892335985e-12,167440655,5390364,226445496
1270000,2246669000,21483779,2.900310165e-12,169360354,5427464,231872960
1275000,2077419625,21395965,2.888455275e-12,165120520,5329644,237202604
1280000,2201496958,21322005,2.878470675e-12,164102696,5311084,242513688
1285000,2216058208,21275012,2.8721266200000004e-12,162575418,5273292,247786980
1290000,2245429042,21296817,2.875070295e-12,163284067,5292196,253079176
1295000,4171977084,21356911,2.8831829849999996e-12,163851256,5298928,258378104
1300000,2097896916,21302070,2.8757794499999998e-12,163454799,5288112,263666216
1305000,2305065292,21336529,2.8804314150000004e-12,164574745,5294256,268960472
1310000,3066814750,21472301,2.898760635e-12,167601457,5383844,274344316
1315000,3600639791,21462563,2.8974460050000003e-12,168670824,5409728,279754044
1320000,2088177708,21489856,2.90113056e-12,169557860,5426988,285181032
1325000,2289316042,21432724,2.89341774e-12,167701050,5388880,290569912
1330000,11549155792,200580125,2.7078316875e-11,169391840,-81635936,208933976
1335000,2035421584,21456799,2.896667865e-12,168483492,5403968,214337944
1340000,2467737500,21477999,2.899529865e-12,169172512,5421060,219759004
1345000,6494599875,21524771,2.9058440850000005e-12,169191999,5417688,225176692
1350000,2158426042,21474445,2.899050075e-12,169056989,5417508,230594200
1355000,2948989958,21476244,2.8992929400000003e-12,167614884,5376960,235971160
1360000,2101051500,21452868,2.89613718e-12,168355745,5409224,241380384
1365000,2347401083,21444751,2.8950413850000002e-12,168091950,5405896,246786280
1370000,2303580208,21486621,2.900693835e-12,169452704,5431632,252217912
1375000,2190713166,21490952,2.90127852e-12,168092882,5398460,257616372
1380000,2180414250,21494009,2.901691215e-12,169692842,5437876,263054248
1385000,2398308500,21439121,2.894281335e-12,167908971,5394636,268448884
1390000,2289633292,21505381,2.9032264350000004e-12,168561827,5410812,273859696
1395000,2679869833,21452177,2.8960438950000002e-12,168333296,5411976,279271672
1400000,3354421625,21447407,2.895399945e-12,168178250,5410784,284682456
1405000,2182242584,21562949,2.910998115e-12,170432776,5430604,290113060
1410000,2172684542,21448088,2.8954918800000003e-12,168200397,5409192,295522252
1415000,2718778125,21478865,2.899646775e-12,169200629,5434264,300956516
1420000,2180872334,21430879,2.8931686650000002e-12,167641088,5400252,306356768
1425000,2179722917,21480298,2.8998402300000003e-12,167746643,5403024,311759792
1430000,12525465792,214023427,2.8893162645000002e-11,168634856,-87113892,224645900
1435000,2280894750,21446149,2.895230115e-12,168137385,5401120,230047020
1440000,2311285042,21277548,2.87246898e-12,162657842,5275664,235322684
1445000,2268838000,21332622,2.87990397e-12,162838236,5286128,240608812
1450000,7438387917,21290201,2.8741771350000002e-12,163069064,5287144,245895956
1455000,2342580917,21398479,2.888794665e-12,164978606,5313416,251209372
1460000,2633723084,21470089,2.8984620150000004e-12,168915411,5436480,256645852
1465000,2281769500,21434869,2.8937073149999998e-12,167770763,5410776,262056628
1470000,2434012542,21516085,2.904671475e-12,168800812,5433972,267490600
1475000,2248670500,21447736,2.89544436e-12,168188965,5419256,272909856
1480000,2688241708,21473722,2.8989524700000003e-12,169033490,5437456,278347312
1485000,2208133208,21459137,2.896983495e-12,168559504,5424288,283771600
1490000,2165309916,21473348,2.89890198e-12,167411861,5398664,289170264
1495000,2263792209,21470315,2.898492525e-12,168922778,5432156,294602420
1500000,2950045458,21455446,2.89648521e-12,168439534,5423784,300026204
1505000,2257430375,21409331,2.8902596849999997e-12,166940799,5386608,305412812
1510000,2242164167,21540998,2.9080347300000002e-12,169610473,5413412,310826224
1515000,2280304416,21509520,2.9037852e-12,170196940,5438112,316264336
1520000,5204277833,21515004,2.90452554e-12,168765660,5394600,321658936
1525000,2058556667,21475875,2.899243125e-12,169103481,5420408,327079344
1530000,3621181750,21461741,2.8973350350000003e-12,168644100,5413968,332493312
1535000,2041796792,21432114,2.8933353900000004e-12,167681231,5392604,337885916
1540000,12934029917,228892993,3.0900554054999996e-11,168893419,-95956940,241928976
1545000,2054901208,21428288,2.8928188799999998e-12,167556889,5384768,247313744
1550000,2396640625,21476040,2.8992653999999998e-12,169108845,5418052,252731796
1555000,2235222792,21404170,2.88956295e-12,166773057,5361124,258092920
1560000,2752145583,21482101,2.900083635e-12,169305827,5435476,263528396
1565000,5295358708,21482754,2.9001717900000003e-12,167589069,5400492,268928888
1570000,2036943250,21451731,2.895983685e-12,168318778,5421728,274350616
1575000,2493976958,21536434,2.90741859e-12,169333684,5427080,279777696
1580000,2165199833,21463569,2.897581815e-12,168703542,5416316,285194012
1585000,3185401208,21465682,2.89786707e-12,168772209,5421756,290615768
1590000,2330317292,21493469,2.901618315e-12,169675277,5433516,296049284
1595000,2099801459,21468617,2.8982632950000003e-12,167129613,5383840,301433124
1600000,2233586750,21504376,2.90309076e-12,170029751,5442052,306875176
1605000,2671356334,21607448,2.9170054800000004e-12,173379600,5508692,312383868
1610000,3327999458,21529426,2.90647251e-12,169105907,5437020,317820888
1615000,3218758583,21476130,2.89927755e-12,169111757,5440820,323261708
1620000,2110312292,21471790,2.89869165e-12,168970719,5435568,328697276
1625000,2410384250,21545153,2.9085956549999997e-12,171355008,5474268,334171544
1630000,2250388500,21687474,2.9278089900000004e-12,174242479,5544612,339716156
1635000,2233519916,21602592,2.9163499200000003e-12,173221773,5518560,345234716
1640000,2114200792,21628156,2.91980106e-12,174052595,5540612,350775328
1645000,3207132375,21665405,2.924829675e-12,173525223,5527684,356303012
1650000,4868885916,21602807,2.916378945e-12,173228766,5523544,361826556
1655000,15205436042,244556436,3.3015118860000004e-11,174432849,-101823008,260003548
1660000,2036554125,21633113,2.920470255e-12,174213704,5546720,265550268
1665000,2371398041,21601449,2.916195615e-12,173184617,5528852,271079120
1670000,2208379959,21653033,2.9231594549999998e-12,174861097,5557004,276636124
1675000,2286818625,21647854,2.92246029e-12,172830215,5514232,282150356
1680000,3406675583,21636179,2.920884165e-12,174313352,5548060,287698416
1685000,4709952333,21649722,2.92271247e-12,174753512,5551700,293250116
1690000,3006607125,21672261,2.9257552350000004e-12,173623436,5527932,298778048
1695000,2231787417,21649866,2.9227319100000004e-12,174758183,5551476,304329524
1700000,2565352500,21592911,2.915042985e-12,172907143,5515244,309844768
1705000,2208828042,21710715,2.930946525e-12,174873182,5547176,315391944
1710000,2980939666,21625980,2.9195073e-12,173981870,5542500,320934444
1715000,2125613584,21576857,2.912875695e-12,172385379,5508028,326442472
1720000,2742580125,21610737,2.917449495e-12,173486504,5535136,331977608
1725000,2254220250,21625564,2.91945114e-12,172105785,5506116,337483724
1730000,2496084250,21636818,2.92097043e-12,174334129,5555452,343039176
1735000,2382626166,21581445,2.913495075e-12,172534510,5508172,348547348
1740000,2491516417,21585795,2.914082325e-12,172675871,5511252,354058600
1745000,2365858167,21440725,2.894497875e-12,167961077,5395640,359454240
1750000,2203202959,21445235,2.8951067250000003e-12,168107657,5400532,364854772
1755000,3050133083,21501332,2.90267982e-12,169930833,5429040,370283812
1760000,2316426458,21419557,2.891640195e-12,167273142,5393220,375677032
1765000,2344685916,21471120,2.8986012e-12,168948933,5430280,381107312
1770000,2254287625,21451156,2.8959060599999998e-12,168300088,5407132,386514444
1775000,15119660166,260566422,3.5176466970000005e-11,169622171,-107658780,278855664
1780000,2472490000,21659833,2.9240774549999998e-12,175082091,5551764,284407428
1785000,3638208916,21666688,2.92500288e-12,173313806,5518264,289925692
1790000,2272236625,21658537,2.923902495e-12,175039970,5555128,295480820
1795000,2945419000,21623518,2.91917493e-12,173901862,5524972,301005792
1800000,2250384000,21639053,2.921272155e-12,174406770,5540920,306546712
1805000,2553363000,21707164,2.9304671400000004e-12,174629275,5540920,312087632
1810000,2255382417,21644898,2.92206123e-12,174596713,5556700,317644332
1815000,6459175375,21680352,2.92684752e-12,173558789,5532124,323176456
1820000,2599867208,21651754,2.92298679e-12,174819539,5560180,328736636
1825000,2203643458,21606011,2.916811485e-12,173332895,5519272,334255908
1830000,2588693500,21653288,2.92319388e-12,174869395,5556240,339812148
1835000,2283172375,21693844,2.92866894e-12,174196371,5536908,345349056
1840000,2586126125,21626029,2.9195139149999997e-12,173983483,5540480,350889536
1845000,2091151167,21660591,2.924179785e-12,175106746,5554472,356444008
1850000,3203911084,21662778,2.9244750300000003e-12,173186753,5517480,361961488
1855000,2270475834,21664459,2.9247019649999997e-12,175232452,5538988,367500476
1860000,2381249375,21464639,2.8977262649999998e-12,168738308,5404708,372905184
1865000,2072062167,21596608,2.91554208e-12,173027277,5513184,378418368
1870000,2623952375,21681193,2.9269610550000003e-12,173785218,5539080,383957448
1875000,2248638083,21635845,2.920839075e-12,174302477,5541828,389499276
1880000,2746862667,21590201,2.914677135e-12,172819065,5508880,395008156
1885000,2130734750,21652000,2.9230199999999998e-12,174827533,5558232,400566388
1890000,2399807416,21858437,2.9508889949999997e-12,179545671,5661252,406227640
1895000,2376053000,21692794,2.92852719e-12,176153339,5588652,411816292
1900000,2172490209,21651954,2.92301379e-12,174826039,5558284,417374576
1905000,14179620083,278228358,3.756082833e-11,174261170,-118085676,299288900
1910000,3020461958,21482968,2.9002006800000003e-12,169333991,5418460,304707360
1915000,2152095500,21477186,2.89942011e-12,169146068,5415812,310123172
1920000,2831466083,21530745,2.906650575e-12,168743771,5403132,315526304
1925000,2286958167,21443090,2.8948171500000004e-12,168037946,5389248,320915552
1930000,2466541375,21511411,2.904040485e-12,170258376,5433792,326349344
1935000,3671183000,21534552,2.9071645200000003e-12,168867480,5406748,331756092
1940000,3133218709,21476029,2.899263915e-12,169108467,5406236,337162328
1945000,2219508125,21475533,2.899196955e-12,169092362,5406992,342569320
1950000,2242251792,21490452,2.9012110200000003e-12,169577212,5414204,347983524
1955000,2147906875,21505441,2.9032345350000002e-12,170064355,5412528,353396052
1960000,9499138166,21512453,2.9041811550000004e-12,168149261,5415680,358811732
1965000,2238955209,21432362,2.89336887e-12,167689305,5400132,364211864
1970000,3382767459,21424833,2.892352455e-12,167444587,5391820,369603684
1975000,2252016083,21443505,2.8948731750000004e-12,168051432,5402316,375006000
1980000,2468559875,21596404,2.91551454e-12,173020672,5523364,380529364
1985000,2057112334,21637216,2.92102416e-12,174347058,5545484,386074848
1990000,2991333334,21655916,2.9235486599999997e-12,172811815,5514992,391589840
1995000,2245466542,21586331,2.914154685e-12,172693285,5510076,397099916
2000000,2757470750,21631881,2.9203039350000003e-12,174173672,5531688,402631604
2005000,2278452416,21595309,2.915366715e-12,172985077,5526304,408157908
2010000,2851117583,21738389,2.934682515e-12,175492193,5546500,413704408
2015000,2212414333,21639481,2.9213299349999997e-12,174420660,5532200,419236608
2020000,2708832625,21613609,2.9178372150000003e-12,173579812,5511128,424747736
2025000,2055796167,21624987,2.9193732450000003e-12,173949596,5523936,430271672
2030000,2198402792,21670603,2.9255314049999998e-12,173289131,5517328,435789000
2035000,2274648250,21653086,2.9231666099999997e-12,174862837,5545780,441334780
2040000,3196387458,21588817,2.914490295e-12,172774091,5508416,446843196
2045000,14064776583,297030839,4.0099163265000005e-11,174874821,-125563284,321279912
2050000,2353151042,21671919,2.9257090650000002e-12,173179794,5518132,326798044
2055000,2301341583,21663983,2.924637705e-12,175216969,5556116,332354160
2060000,2489465250,21698657,2.929318695e-12,174048766,5538700,337892860
2065000,2255622375,21570045,2.911956075e-12,172164010,5501668,343394528
2070000,3091842333,21614741,2.917990035e-12,173616623,5537880,348932408
2075000,2227366791,21603939,2.9165317650000004e-12,173265560,5527316,354459724
2080000,2883623833,21694446,2.92875021e-12,173911912,5541592,360001316
2085000,2125549625,21626599,2.919590865e-12,174001990,5534000,365535316
2090000,2259931292,21593334,2.9151000900000003e-12,172920896,5511944,371047260
2095000,2342629583,21635337,2.920770495e-12,174285979,5538152,376585412
2100000,2096194583,21587600,2.914326e-12,172734531,5509504,382094916
2105000,2638394625,21568911,2.911802985e-12,172127154,5481212,387576128
2110000,4723970833,21623604,2.91918654e-12,173904672,5536248,393112376
2115000,3265185666,21543500,2.9083725e-12,169006183,5423064,398535440
2120000,2819397375,21500510,2.90256885e-12,169904124,5436244,403971684
2125000,2053656125,21442246,2.89470321e-12,168010538,5404756,409376440
2130000,2275609375,21454484,2.89635534e-12,168408252,5408948,414785388
2135000,2095082167,21456205,2.896587675e-12,168464203,5408172,420193560
2140000,2246852375,21581443,2.913494805e-12,170239303,5448416,425641976
2145000,2516179375,21614733,2.9179889550000002e-12,173616343,5520904,431162880
2150000,2048205834,21513375,2.9043056250000005e-12,170322215,5452112,436614992
2155000,2936492459,21596476,2.91552426e-12,170727901,5442612,442057604
2160000,2113110458,21456136,2.8965783599999997e-12,168461962,5413892,447471496
2165000,2875988041,21505519,2.9032450649999997e-12,170066888,5452956,452924452
2170000,2110160500,21583245,2.913738075e-12,172592999,5499412,458423864
2175000,2315762417,21681735,2.927034225e-12,173498794,5522344,463946208
2180000,2240428000,21629344,2.91996144e-12,174091214,5536100,469482308
2185000,2472894000,21633814,2.92056489e-12,174236476,5536116,475018424
2190000,3462920375,21703994,2.9300391899999998e-12,174222212,5535492,480553916
2195000,18937804625,317215575,4.2824102625e-11,173898421,-135706328,344847588
2200000,2895895959,21640258,2.9214348300000002e-12,174445919,5539072,350386660
2205000,2230166042,21692822,2.9285309699999998e-12,173689766,5524956,355911616
2210000,2194641459,21600306,2.91604131e-12,173147469,5520760,361432376
2215000,2232532584,21586135,2.914128225e-12,172686928,5517996,366950372
2220000,2039555000,21653495,2.923221825e-12,174876110,5558808,372509180
2225000,2232223208,21590560,2.9147256e-12,172830740,5517784,378026964
2230000,2856838541,21653827,2.923266645e-12,174886907,5558092,383585056
2235000,2246473375,21603032,2.91640932e-12,173236071,5519288,389104344
2240000,2882288084,21682943,2.927197305e-12,173368692,5525932,394630276
2245000,2131350375,21658464,2.92389264e-12,175037615,5553008,400183284
2250000,3182864500,21609336,2.91726036e-12,173440964,5525888,405709172
2255000,4038831041,21738966,2.93476041e-12,175189453,5540800,411249972
2260000,5019668333,21639272,2.92130172e-12,174413859,5547620,416797592
2265000,2228600750,21572326,2.9122640100000003e-12,172238127,5501892,422299484
2270000,9501651542,21726443,2.933069805e-12,174782472,5554820,427854304
2275000,2042363708,21680689,2.926893015e-12,173295451,5524716,433379020
2280000,2877066292,21652412,2.92307562e-12,174840910,5555684,438934704
2285000,2134663708,21499918,2.9024889299999997e-12,169884875,5440136,444374840
2290000,2506718708,21501529,2.902706415e-12,169937225,5432996,449807836
2295000,2137654125,21538068,2.90763918e-12,168660281,5409308,455217144
2300000,3089275500,21451823,2.895996105e-12,168321786,5401756,460618900
2305000,2098108042,21495580,2.9019033000000003e-12,169743871,5415612,466034512
2310000,2083734584,21591872,2.9149027199999997e-12,172873369,5511260,471545772
2315000,2243948458,21583573,2.913782355e-12,172603640,5507624,477053396
2320000,2042685375,21454713,2.896386255e-12,168415702,5409824,482463220
2325000,2651957209,21564392,2.91119292e-12,171980262,5489868,487953088
2330000,3147837625,21685400,2.9275290000000004e-12,173448559,5524412,493477500
2335000,2209760416,21626012,2.91951162e-12,173982928,5531492,499008992
2340000,2308258417,21588771,2.914484085e-12,172772582,5507320,504516312
2345000,2234599167,21703141,2.929924035e-12,174025128,5535316,510051628
2350000,2088358917,21592967,2.9150505450000003e-12,172908966,5507136,515558764
2355000,17813845750,338728558,4.572835533e-11,172801142,-145573048,369985716
2360000,2066219583,21728627,2.9333646450000004e-12,174675739,5555852,375541568
2365000,2289056959,21596071,2.9154695849999997e-12,173009848,5518492,381060060
2370000,2279025667,21596239,2.915492265e-12,173015315,5517864,386577924
2375000,2104784125,21626721,2.919607335e-12,174005946,5536380,392114304
2380000,2266799708,21617791,2.918401785e-12,173715750,5529088,397643392
2385000,2295391459,21655925,2.923549875e-12,174955087,5559948,403203340
2390000,2092583833,21599687,2.9159577449999997e-12,173127355,5523712,408727052
2395000,3672200875,21732105,2.9338341750000002e-12,174788756,5557776,414284828
2400000,2174678792,21596806,2.91556881e-12,173033732,5507636,419792464
2405000,2277129875,21652479,2.923084665e-12,174843113,5534392,425326856
2410000,2199626167,21699839,2.9294782650000003e-12,173740098,5526696,430853552
2415000,2261707000,21665338,2.9248206300000003e-12,175261008,5557428,436410980
2420000,2226117667,21640910,2.9215228500000003e-12,174467122,5535796,441946776
2425000,2235404458,21750436,2.9363088600000003e-12,175384529,5554140,447500916
2430000,2418221625,21616209,2.9181882150000002e-12,173664343,5531664,453032580
2435000,2271429792,21552314,2.90956239e-12,171587740,5480544,458513124
2440000,8598548042,21417909,2.891417715e-12,167219567,5387200,463900324
2445000,3901960750,21528912,2.90640312e-12,167920755,5394576,469294900
2450000,2102540875,21531536,2.9067573599999998e-12,168270285,5397740,474692640
2455000,2536049292,21546076,2.90872026e-12,171385011,5456108,480148748
2460000,2195763583,21568625,2.911764375e-12,172117846,5514852,485663600
2465000,2455671583,21595541,2.915398035e-12,172992598,5521552,491185152
2470000,4063048125,21677398,2.92644873e-12,173010795,5530428,496715580
2475000,2281691917,21607320,2.9169882e-12,173375421,5534532,502250112
2480000,2095283583,21634835,2.9207027250000002e-12,174269675,5547196,507797308
2485000,2230617708,21682039,2.927075265e-12,173161613,5519600,513316908
2490000,2266108875,21606777,2.916914895e-12,173357787,5525436,518842344
2495000,2053767083,21612353,2.9176676549999997e-12,173539020,5530296,524372640
2500000,2240142333,21603101,2.916418635e-12,173238296,5532500,529905140
2505000,3012206583,21690440,2.9282093999999998e-12,173434659,5510628,535415768
2510000,2326438750,21640581,2.9214784349999998e-12,174456406,5526824,540942592
2515000,2141839541,21616978,2.9182920300000003e-12,173689306,5507804,546450396
2520000,2311857833,21747548,2.9359189800000003e-12,175290670,5543952,551994348
2525000,18036664125,361548703,4.8809074905e-11,173935016,-155305832,396688516
2530000,2056005708,21761611,2.937817485e-12,174995107,5553120,402241636
2535000,2036569000,21606039,2.916815265e-12,173333796,5520260,407761896
2540000,2571370084,21733254,2.93398929e-12,174639300,5551296,413313192
2545000,3522844167,21598682,2.91582207e-12,173094709,5513344,418826536
2550000,2311611375,21650284,2.92278834e-12,174771756,5553132,424379668
2555000,2053577292,21672935,2.9258462250000003e-12,175507922,5550424,429930092
2560000,2986661958,21580661,2.913389235e-12,172509015,5510080,435440172
2565000,2276587375,21617454,2.91835629e-12,173704799,5540120,440980292
2570000,2509562459,21705578,2.93025303e-12,173739827,5533708,446514000
2575000,2225815792,21608441,2.9171395350000004e-12,173411857,5522556,452036556
2580000,2534364458,21593322,2.91509847e-12,172920515,5512644,457549200
2585000,2180405208,21629545,2.919988575e-12,174097746,5532492,463081692
2590000,2736995583,21653820,2.9232657e-12,172057678,5497004,468578696
2595000,2274132667,21609137,2.9172334950000002e-12,173434475,5530260,474108956
2600000,2930632250,21577206,2.91292281e-12,172396735,5507060,479616016
2605000,2317421917,21637427,2.921052645e-12,171524903,5476272,485092288
2610000,2233045000,21626322,2.91955347e-12,173992995,5551576,490643864
2615000,2827744541,21721310,2.93237685e-12,177080096,5619700,496263564
2620000,2831798083,21826711,2.9466059850000003e-12,177676645,5631472,501895036
2625000,2315624583,21626251,2.919543885e-12,173990688,5546404,507441440
2630000,4707583709,21584515,2.913909525e-12,172634277,5522324,512963764
2635000,4710554417,21735684,2.93431734e-12,174435374,5559312,518523076
2640000,2840792750,21587713,2.914341255e-12,172738209,5519380,524042456
2645000,4792025750,21625301,2.919415635e-12,173959801,5538908,529581364
2650000,2298092209,21694499,2.9287573649999997e-12,173379760,5527716,535109080
2655000,2243470250,21679529,2.926736415e-12,175722227,5563964,540673044
2660000,2587092208,21769273,2.938851855e-12,178638896,5652988,546326032
2665000,2093184625,21730865,2.933666775e-12,177390660,5622260,551948292
2670000,2187487791,21874187,2.9530152449999997e-12,179219621,5662228,557610520
2675000,2130073625,21741594,2.93511519e-12,177739330,5626656,563237176
2680000,2129658292,21792786,2.94202611e-12,179403091,5666360,568903536
2685000,2310841834,21821879,2.9459536650000004e-12,177519594,5625708,574529244
2690000,2108394583,21780155,2.940320925e-12,178992557,5657940,580187184
2695000,3215342459,21740907,2.935022445e-12,177717010,5628680,585815864
2700000,2988320583,21866042,2.95191567e-12,178954888,5661424,591477288
2705000,22227151083,386124466,5.212680291e-11,179107899,-166512612,424964676
2710000,2034948375,21768241,2.938712535e-12,178605370,5657592,430622268
2715000,2469314042,21795939,2.9424517650000004e-12,179505541,5674252,436296520
2720000,2169120625,21749530,2.93618655e-12,177997265,5639668,441936188
2725000,2753539208,21855024,2.95042824e-12,178396074,5648596,447584784
2730000,2284121541,21803149,2.943425115e-12,179739891,5676692,453261476
2735000,2110236208,21759919,2.9375890650000004e-12,178334894,5642088,458903564
2740000,2186631792,21876327,2.953304145e-12,179088401,5662196,464565760
2745000,2274052750,21758916,2.93745366e-12,178302313,5645780,470211540
2750000,2255998084,21661901,2.924356635e-12,175149334,5579812,475791352
2755000,2655751209,21643416,2.9218611599999998e-12,174548563,5547628,481338980
2760000,2120812125,21728383,2.933331705e-12,174280242,5550876,486889856
2765000,2234280917,21590264,2.91468564e-12,172821111,5519404,492409260
2770000,2221725209,21652815,2.923130025e-12,174854022,5562948,497972208
2775000,2882271292,21812255,2.944654425e-12,177006058,5608896,503581104
2780000,2061786042,21789866,2.94163191e-12,179308178,5663948,509245052
2785000,2491345083,21756270,2.93709645e-12,178216303,5637028,514882080
2790000,2185620708,21743114,2.93532039e-12,177788751,5625188,520507268
2795000,2525760667,21903785,2.957010975e-12,179980791,5674436,526181704
2800000,2222819708,21752895,2.9366408250000004e-12,178106618,5635820,531817524
2805000,2707526667,21829003,2.946915405e-12,180580134,5670524,537488048
2810000,2084681875,21750675,2.936341125e-12,178034483,5634852,543122900
2815000,2268088166,21861714,2.9513313900000004e-12,178613478,5657664,548780564
2820000,2243512667,21794929,2.9423154149999996e-12,179472733,5678072,554458636
2825000,2316717042,21780822,2.94041097e-12,179014244,5662800,560121436
2830000,2283995458,21885162,2.9544968700000004e-12,179375544,5672352,565793788
2835000,4711462833,21781394,2.9404881900000002e-12,179032834,5658472,571452260
2840000,15117798542,21855276,2.9504622599999997e-12,178404267,5644408,577096668
2845000,2375342083,21897033,2.956099455e-12,179761350,5673776,582770444
2850000,2330389375,21787435,2.941303725e-12,179229180,5661768,588432212
2855000,2121898959,21743393,2.935358055e-12,177797792,5621668,594053880
2860000,2276903584,21851077,2.949895395e-12,178267786,5644620,599698500
2865000,2376703833,21764528,2.9382112799999996e-12,178484680,5652700,605351200
2870000,2230837916,21796869,2.942577315e-12,179535772,5669448,611020648
2875000,2168660334,21771835,2.939197725e-12,178722183,5650516,616671164
2880000,2088903750,21805455,2.943736425e-12,179814817,5678276,622349440
2885000,2387793833,21770066,2.93895891e-12,178664677,5650880,628000320
2890000,2058958958,21753752,2.9367565200000003e-12,178134467,5637260,633637580
2895000,24215733834,411735151,5.5584245385e-11,178407064,-178820280,454817300
2900000,2032264000,21872632,2.95280532e-12,178755360,5652212,460469512
2905000,4802684125,21808006,2.9440808100000003e-12,179897732,5654476,466123988
2910000,2034637084,21787591,2.9413247850000002e-12,179234228,5663004,471786992
2915000,2345381708,21744847,2.935554345e-12,174602355,5563156,477350148
2920000,2226182041,21612400,2.917674e-12,173540542,5531272,482881420
2925000,2296480333,21603615,2.916488025e-12,173255026,5525316,488406736
2930000,2329864541,21604344,2.91658644e-12,173278706,5521400,493928136
2935000,2352606833,21770337,2.938995495e-12,175430766,5569008,499497144
2940000,2137928125,21777534,2.93996709e-12,178907389,5639716,505136860
2945000,2370149583,21785734,2.94107409e-12,179173890,5648372,510785232
2950000,2248167917,21767363,2.9385940050000004e-12,178576817,5633972,516419204
2955000,2197315459,21857636,2.9507808600000002e-12,178267970,5634836,522054040
2960000,2151373250,21801224,2.9431652400000003e-12,179677301,5677364,527731404
2965000,2317537166,21754208,2.93681808e-12,178149281,5652112,533383516
2970000,2287408167,21866904,2.9520320399999998e-12,178569201,5663236,539046752
2975000,4682328250,21785905,2.941097175e-12,179179454,5668740,544715492
2980000,2111712500,21771261,2.9391202350000003e-12,178703534,5662496,550377988
2985000,2406892625,21794419,2.9422465650000003e-12,179456137,5673836,556051824
2990000,2256990125,21724731,2.932838685e-12,177191289,5628780,561680604
2995000,2636518458,21783742,2.94080517e-12,179109151,5671092,567351696
3000000,2078044458,21739717,2.934861795e-12,177678327,5636892,572988588
3005000,2429820000,21852781,2.9501254350000003e-12,178110184,5642156,578630744
3010000,2336342000,21753284,2.9366933400000003e-12,178119271,5642968,584273712
3015000,2686458167,21752966,2.9366504100000003e-12,178108938,5643516,589917228
3020000,2084089834,21815361,2.945073735e-12,180136754,5677828,595595056
3025000,2114269583,21845913,2.949198255e-12,177887002,5629860,601224916
3030000,2221148125,21796655,2.9425484249999997e-12,179528812,5678148,606903064
3035000,2334764667,21776205,2.9397876750000002e-12,178864176,5654272,612557336
3040000,2295681375,21893499,2.955622365e-12,179433541,5669012,618226348
3045000,8544126500,21804660,2.9436291e-12,179788979,5675852,623902200
3050000,14367831541,21980656,2.96738856e-12,179023406,5655548,629557748
3055000,2112432875,21774908,2.93961258e-12,178822035,5645772,635203520
3060000,2615077209,21741229,2.935065915e-12,177727473,5637232,640840752
3065000,2040655458,21849694,2.94970869e-12,178009858,5642588,646483340
3070000,2272210000,21761877,2.9378533949999997e-12,178398525,5650404,652133744
3075000,2444254958,21696711,2.9290559850000002e-12,176280645,5596692,657730436
3080000,2249453833,21625126,2.9193920099999998e-12,173954123,5540696,663271132
3085000,2871552792,21718737,2.9320294950000003e-12,173753770,5537864,668808996
3090000,2168872000,21575145,2.9126445750000002e-12,172329744,5509140,674318136
3095000,2309403125,21595041,2.9153305350000002e-12,172976384,5523768,679841904
3100000,22319678125,439187233,5.9290276455e-11,173154671,-192818816,487023088
3105000,2043554375,21610264,2.91738564e-12,173471117,5509404,492532492
3110000,2102379459,21782441,2.940629535e-12,179066864,5655828,498188320
3115000,2661609791,21766602,2.93849127e-12,178552105,5644768,503833088
3120000,2148992167,21860610,2.95118235e-12,178133235,5637412,509470500
3125000,2582278125,21767014,2.9385468900000004e-12,178565481,5646192,515116692
3130000,2214647167,21785348,2.94102198e-12,179161345,5659488,520776180
3135000,2194519084,21776673,2.939850855e-12,178879411,5650452,526426632
3140000,2286860583,21864604,2.95172154e-12,178263054,5641256,532067888
3145000,2079841583,21755771,2.937029085e-12,178200099,5634292,537702180
3150000,2236892084,21790057,2.941657695e-12,179314384,5657028,543359208
3155000,3174040291,21879158,2.9536863300000003e-12,178736048,5641688,549000896
3160000,2293259625,21796545,2.942533575e-12,179525253,5661696,554662592
3165000,2219464084,21763965,2.9381352750000003e-12,178466408,5647040,560309632
3170000,2292380583,21813776,2.94485976e-12,180085265,5671328,565980960
3175000,2162053750,21862412,2.95142562e-12,178191787,5637108,571618068
3180000,2462384833,21809232,2.9442463199999998e-12,179937560,5666820,577284888
3185000,3662794834,21755736,2.93702436e-12,178198949,5635112,582920000
3190000,2257397667,21914341,2.958436035e-12,179879486,5668788,588588788
3195000,2932517917,21770309,2.9389917150000003e-12,178672562,5640456,594229244
3200000,2221656833,21780121,2.940316335e-12,178991480,5650532,599879776
3205000,2067656250,21828180,2.9468043e-12,180553374,5670300,605550076
3210000,2268404375,21726948,2.93313798e-12,173789222,5526588,611076664
3215000,2209447000,21627285,2.9196834750000003e-12,174024315,5538020,616614684
3220000,2249435667,21644717,2.922036795e-12,174590838,5544768,622159452
3225000,2388010792,21688202,2.92790727e-12,172529977,5493172,627652624
3230000,2270053291,21687100,2.9277585e-12,175968269,5569736,633222360
3235000,2303403041,21777640,2.9399814e-12,178910820,5640520,638862880
3240000,2212808291,21738555,2.934704925e-12,177640575,5611464,644474344
3245000,2764612459,21754449,2.9368506150000002e-12,174683007,5530280,650004624
3250000,2533506042,21650577,2.922827895e-12,174781285,5538824,655543448
3255000,4396032375,21669850,2.9254297500000002e-12,175407672,5536320,661079768
3260000,2147108542,21709558,2.93079033e-12,173224048,5510192,666589960
3265000,14725244625,21648453,2.9225411550000003e-12,174712271,5544100,672134060
3270000,3625390083,21743523,2.935375605e-12,173980503,5523972,677658032
3275000,2089518166,21701484,2.92970034e-12,172961655,5501184,683159216
3280000,2202228875,21677676,2.92648626e-12,175661999,5558828,688718044
3285000,2146514625,21616770,2.9182639500000004e-12,173682563,5514212,694232256
3290000,2057867834,21600932,2.91612582e-12,173167835,5504428,699736684
3295000,2241404333,21790833,2.9417624550000002e-12,175865491,5555948,705292632
3300000,2825002042,21603561,2.9164807350000002e-12,173253276,5508436,710801068
3305000,2251676625,21701703,2.929729905e-12,176442890,5562112,716363180
3310000,2306696708,21500938,2.90262663e-12,169918013,5430980,721794160
3315000,2289373667,21449243,2.895647805e-12,168237938,5385180,727179340
3320000,28446459250,468720478,6.327726453e-11,170156366,-205588408,521590932
3325000,2406944875,21628639,2.9198662650000003e-12,174068303,5507368,527098300
3330000,2868472458,21689232,2.92804632e-12,176037568,5553544,532651844
3335000,2261781416,21653894,2.9232756900000003e-12,174889103,5528436,538180280
3340000,2269417541,21763017,2.9380072949999997e-12,174719633,5531192,543711472
3345000,2260997250,21666464,2.92497264e-12,175297610,5544248,549255720
3350000,2209953458,21643178,2.9218290300000004e-12,174540816,5521244,554776964
3355000,2246118125,21772734,2.93931909e-12,175035439,5522704,560299668
3360000,2668846834,21619019,2.918567565e-12,173755645,5512344,565812012
3365000,2142848458,21633861,2.9205712350000003e-12,174238008,5525464,571337476
3370000,2188653167,21657874,2.92381299e-12,175018438,5541016,576878492
3375000,2238975958,21719923,2.9321896050000003e-12,173319092,5506072,582384564
3380000,2041126583,21668592,2.92525992e-12,175366771,5542604,587927168
3385000,2263348625,21605887,2.9167947450000002e-12,173328852,5504044,593431212
3390000,2139238292,21647535,2.922417225e-12,174682429,5536420,598967632
3395000,2220450792,21644194,2.92196619e-12,174573841,5535108,604502740
3400000,2091155792,21641546,2.9216087100000003e-12,174487794,5532524,610035264
3405000,2265635166,21748038,2.93598513e-12,174232820,5518680,615553944
3410000,2190183333,21674012,2.92599162e-12,175542931,5555272,621109216
3415000,2201856917,21598800,2.9158380000000003e-12,173098520,5516932,626626148
3420000,2171993583,21644899,2.922061365e-12,174596740,5558680,632184828
3425000,2311036042,21722620,2.9325536999999998e-12,177122677,5617732,637802560
3430000,2341767958,21763116,2.9380206600000005e-12,178438788,5644696,643447256
3435000,2266277625,21788183,2.9414047049999997e-12,179253476,5655340,649102596
3440000,2191912084,21882948,2.95419798e-12,178617404,5649412,654752008
3445000,2248106417,21803073,2.943414855e-12,179737406,5673264,660425272
3450000,2229251417,21750946,2.9363777100000004e-12,178043277,5640664,666065936
3455000,2439734459,21939109,2.961779715e-12,180442608,5663064,671729000
3460000,3276037375,21725668,2.9329651799999997e-12,177221748,5635052,677364052
3465000,2246982542,21723919,2.932729065e-12,177164904,5636240,683000292
3470000,3045044459,21900350,2.9565472500000004e-12,179182972,5675840,688676132
3475000,2236008500,21711460,2.9310470999999997e-12,176759972,5627184,694303316
3480000,2579563083,21779550,2.9402392500000004e-12,178972919,5671880,699975196
3485000,2121520500,21741055,2.935042425e-12,177721814,5646336,705621532
3490000,2272931250,21907762,2.95754787e-12,179423852,5670356,711291888
3495000,2039289958,21748735,2.936079225e-12,177971426,5643724,716935612
3500000,14860279917,21901791,2.956741785e-12,178858192,5665808,722601420
3505000,2093107625,21801760,2.9432376e-12,179694721,5666124,728267544
3510000,2733168750,21826008,2.94651108e-12,176766834,5616176,733883720
3515000,2117374208,21781918,2.94055893e-12,179049857,5654012,739537732
3520000,2055039583,21739799,2.934872865e-12,177681000,5622192,745159924
3525000,8216738875,21928749,2.960381115e-12,180105911,5678584,750838508
3530000,3759934417,21756591,2.937139785e-12,178226736,5644620,756483128
3535000,2862700750,21873076,2.95286526e-12,178296547,5644492,762127620
3540000,2043213750,21804653,2.9436281549999996e-12,179788762,5675788,767803408
3545000,2366156959,21736803,2.9344684050000002e-12,177583626,5625336,773428744
3550000,2250348167,21920210,2.95922835e-12,179828397,5673432,779102176
3555000,29574815583,500640172,6.758642322e-11,179189050,-220592256,558509920
3560000,2324185667,22023079,2.973115665e-12,182908281,5748700,564258620
3565000,2135285125,21824337,2.9462854950000003e-12,180428466,5694336,569952956
3570000,2257338542,21592313,2.9149622550000003e-12,172887714,5514604,575467560
3575000,2440775292,21583504,2.91377304e-12,172601417,5507164,580974724
3580000,2307636542,21730249,2.933583615e-12,173391278,5521620,586496344
3585000,2144289584,21577013,2.912896755e-12,172390468,5507836,592004180
3590000,2199224834,21600529,2.916071415e-12,173154711,5521724,597525904
3595000,3360884667,21588586,2.9144591099999997e-12,172766592,5513012,603038916
3600000,2104752166,21631325,2.920228875e-12,174155582,5540644,608579560
3605000,2533398875,21759627,2.937549645e-12,178325409,5609180,614188740
3610000,2271152458,21912249,2.9581536150000003e-12,179306305,5665512,619854252
3615000,2588787958,21815360,2.9450736e-12,180136739,5676428,625530680
3620000,2144896791,21765024,2.9382782400000004e-12,178500820,5644212,631174892
3625000,2450305667,21792497,2.941987095e-12,179393679,5667792,636842684
3630000,2329435042,21923632,2.9596903200000002e-12,179676247,5659472,642502156
3635000,2256836833,21767094,2.93855769e-12,178568083,5641512,648143668
3640000,2287874292,21819757,2.945667195e-12,180279640,5669636,653813304
3645000,2616326667,21896669,2.9560503150000002e-12,178799952,5641440,659454744
3650000,2091320083,21822515,2.946039525e-12,180369256,5676864,665131608
3655000,3013293333,21788617,2.941463295e-12,179267597,5642256,670773864
3660000,2115487208,21650760,2.9228526e-12,174787238,5543860,676317724
3665000,2931557083,21735108,2.93423958e-12,173549218,5526640,681844364
3670000,2113407416,21612261,2.917655235e-12,173536008,5522572,687366936
3675000,2460702709,21611848,2.91759948e-12,173522600,5519548,692886484
3680000,2249264500,21661518,2.92430493e-12,175136879,5552120,698438604
3685000,2686333000,21613030,2.91775905e-12,173561023,5519936,703958540
3690000,2313798166,21660685,2.924192475e-12,175109795,5554312,709512852
3695000,2469031625,21733052,2.93396202e-12,173482376,5521564,715034416
3700000,2247659250,21663547,2.9245788450000003e-12,175202803,5554780,720589196
3705000,2434651500,21624591,2.919319785e-12,173936738,5508148,726097344
3710000,2131940333,21628479,2.9198446650000004e-12,174063097,5537784,731635128
3715000,2064936792,21897038,2.95610013e-12,178811954,5644128,737279256
3720000,2255285792,21724049,2.932746615e-12,177169126,5604528,742883784
3725000,2834677667,21633123,2.9204716050000003e-12,174214029,5524844,748408628
3730000,5556263334,21754118,2.93680593e-12,174167034,5521488,753930116
3735000,6454660791,21619530,2.91863655e-12,173772256,5517084,759447200
3740000,8916664834,21772326,2.93926401e-12,174758782,5528540,764975740
3745000,2239583250,21761134,2.93775309e-12,174395062,5524512,770500252
3750000,2969021750,21617070,2.91830445e-12,173692297,5512144,776012396
3755000,2033976583,21519783,2.905170705e-12,170530484,5415512,781427908
3760000,2772538541,21617344,2.9183414400000002e-12,169721885,5426388,786854296
3765000,2066387625,21463230,2.8975360500000003e-12,168692521,5393200,792247496
3770000,2460445459,21490776,2.90125476e-12,169587747,5414272,797661768
3775000,9541546375,21598203,2.9157574050000004e-12,168701881,5400132,803061900
3780000,2262089500,21548658,2.90906883e-12,171468929,5460160,808522060
3785000,2052265708,21659485,2.924030475e-12,175070806,5540248,814062308
3790000,2330606042,21628917,2.9199037950000004e-12,174077351,5517424,819579732
3795000,2440434459,21687421,2.9278018350000004e-12,175978699,5554752,825134484
3800000,2312877625,21637110,2.9210098500000002e-12,174343622,5521024,830655508
3805000,4532163041,21815554,2.94509979e-12,176163694,5537548,836193056
3810000,33509089500,535014495,7.2226956825e-11,174218257,-237628968,598564088
3815000,2430446917,21618481,2.918494935e-12,173738147,5509644,604073732
3820000,2272310083,21658015,2.923832025e-12,175023007,5534988,609608720
3825000,2347109792,21643795,2.921912325e-12,174560862,5526552,615135272
3830000,2253797792,21786405,2.941164675e-12,174929380,5536564,620671836
3835000,2070327916,21608339,2.917125765e-12,173408538,5502120,626173956
3840000,2177934875,21653843,2.923268805e-12,174887433,5525972,631699928
3845000,2938166458,21750907,2.936372445e-12,173775714,5504296,637204224
3850000,2188541333,21651273,2.922921855e-12,174803923,5529372,642733596
3855000,3030356792,21639420,2.9213217e-12,174418682,5505920,648239516
3860000,2133097625,21665380,2.9248262999999996e-12,175262371,5555560,653795076
3865000,2299866083,21736301,2.934400635e-12,173301009,5509632,659304708
3870000,3917168875,21662749,2.924471115e-12,175176863,5552180,664856888
3875000,2514155375,21616021,2.9181628350000003e-12,173658220,5517136,670374024
3880000,2332457667,21771951,2.939213385e-12,174459642,5534932,675908956
3885000,2346255417,21650719,2.922847065e-12,174785902,5542776,681451732
3890000,2218987667,21620602,2.91878127e-12,173807102,5523480,686975212
3895000,2561147250,21677510,2.92646385e-12,175656611,5559572,692534784
3900000,2071882750,21753751,2.936756385e-12,173868121,5518020,698052804
3905000,2163342958,21603149,2.916425115e-12,173239884,5486156,703538960
3910000,2266578208,21462042,2.89737567e-12,168653890,5410336,708949296
3915000,2194070708,21438977,2.894261895e-12,167904283,5388404,714337700
3920000,2175959333,21501481,2.902699935e-12,169935661,5425928,719763628
3925000,2882489666,21460731,2.8971986850000003e-12,168611298,5412664,725176292
3930000,2242675000,21473687,2.8989477450000004e-12,169032363,5419204,730595496
3935000,2355537417,21621339,2.9188807649999997e-12,169564739,5422836,736018332
3940000,3473786542,21478993,2.899664055e-12,169204793,5410952,741429284
3945000,2381873583,21520588,2.9052793800000002e-12,170556645,5439144,746868428
3950000,2071485250,21769460,2.9388771e-12,174378675,5524044,752392472
3955000,2345078000,21624041,2.919245535e-12,173918862,5495728,757888200
3960000,2232316792,21611793,2.917592055e-12,173520794,5531108,763419308
3965000,2770265667,21732674,2.9339109899999996e-12,173183145,5510856,768930164
3970000,2129677917,21629246,2.91994821e-12,174088025,5534664,774464828
3975000,2220303416,21595297,2.9153650949999997e-12,172984688,5509680,779974508
3980000,2281839958,21649211,2.922643485e-12,174736886,5548372,785522880
3985000,2385310291,21725024,2.93287824e-12,172934511,5503708,791026588
3990000,2223242458,21652798,2.92312773e-12,174853480,5546568,796573156
3995000,14055826625,21583704,2.9138000400000003e-12,172607921,5501580,802074736
4000000,2038705042,21794152,2.94221052e-12,174327888,5540092,807614828
4005000,2356554459,21776328,2.93980428e-12,174601888,5509724,813124552
4010000,2104019959,21615332,2.91806982e-12,173635807,5515636,818640188
4015000,4697542167,21627386,2.91969711e-12,174027577,5516636,824156824
4020000,2031405041,21790587,2.941729245e-12,175065290,5534560,829691384
4025000,2706181750,21618346,2.91847671e-12,173733782,5507348,835198732
4030000,2058688500,21673112,2.92587012e-12,175513683,5549488,840748220
4035000,5499300625,21629349,2.919962115e-12,174091362,5520496,846268716
4040000,4811999750,21800110,2.94301485e-12,175374788,5544452,851813168
4045000,2308147750,21641509,2.921603715e-12,174486568,5526348,857339516
4050000,2277380292,21665779,2.924880165e-12,175275363,5545132,862884648
4055000,2294578333,21658329,2.923874415e-12,175033208,5526920,868411568
4060000,2247147500,21642835,2.921782725e-12,174529684,5534656,873946224
4065000,2095087791,21662970,2.92450095e-12,170917757,5456412,879402636
4070000,2246909500,21460396,2.8971534599999997e-12,168600414,5402732,884805368
4075000,2411736000,21458446,2.89689021e-12,168537028,5391548,890196916
4080000,2290229792,21626832,2.9196223200000003e-12,169743252,5423716,895620632
4085000,34581159625,571755637,7.7187010995e-11,174333720,-253839776,641780856
4090000,5115585875,21938385,2.961681975e-12,174081493,5515888,647296744
4095000,2043567791,21629943,2.920042305e-12,174110694,5519760,652816504
4100000,2596701208,21629962,2.9200448700000003e-12,174111308,5521080,658337584
4105000,2204974541,21761528,2.9378062799999997e-12,173817396,5492812,663830396
4110000,3023422584,21617421,2.9183518350000003e-12,173703711,5520024,669350420
4115000,2275899959,21621485,2.9189004750000003e-12,173835807,5519332,674869752
4120000,2207637458,21626716,2.91960666e-12,174005806,5522292,680392044
4125000,2288199583,21678407,2.926584945e-12,175685751,5554116,685946160
4130000,2212958166,21641138,2.92155363e-12,174474524,5533280,691479440
4135000,2120439125,21681205,2.9269626750000002e-12,175776690,5561688,697041128
4140000,2214541917,21759518,2.93753493e-12,173752074,5517696,702558824
4145000,2208617709,21648467,2.9225430449999997e-12,174712714,5539716,708098540
4150000,2550353084,21597840,2.9157084e-12,173067334,5504396,713602936
4155000,2248187542,21813876,2.94487326e-12,175518700,5544100,719147036
4160000,5615581416,21642345,2.9217165750000002e-12,174513741,5533884,724680920
4165000,2038891042,21616501,2.918227635e-12,173673806,5512804,730193724
4170000,2911947667,21806027,2.943813645e-12,175263611,5551984,735745708
4175000,2239230500,21602527,2.916341145e-12,173219649,5494872,741240580
4180000,2148480292,21680132,2.92681782e-12,175741817,5552304,746792884
4185000,2291474292,21752106,2.93653431e-12,173511191,5505576,752298460
4190000,2056235542,21658437,2.9238889950000004e-12,175036740,5545212,757843672
4195000,2104696916,21652106,2.92303431e-12,174830974,5534840,763378512
4200000,2406809458,21627272,2.91968172e-12,174023858,5507016,768885528
4205000,2243543042,21816676,2.9452512599999998e-12,175609720,5543996,774429524
4210000,2308307375,21633019,2.920457565e-12,174210652,5533724,779963248
4215000,2254027667,21529495,2.906481825e-12,170846111,5467260,785430508
4220000,2394860125,21476641,2.8993465350000003e-12,169128383,5421812,790852320
4225000,4789162375,21689372,2.92806522e-12,171472342,5467656,796319976
4230000,2735994459,21658378,2.9238810300000003e-12,175034834,5550556,801870532
4235000,2170030125,21770908,2.9390725800000004e-12,174122247,5524952,807395484
4240000,3165037292,21643654,2.92189329e-12,174556295,5534952,812930436
4245000,2225713041,21663667,2.924595045e-12,175206710,5546320,818476756
4250000,2473679500,21496769,2.902063815e-12,169782542,5432676,823909432
4255000,2252967292,21651931,2.923010685e-12,170255502,5430216,829339648
4260000,2656599875,21502349,2.9028171150000002e-12,169963858,5432064,834771712
4265000,2092442750,21536657,2.9074486950000003e-12,171078884,5461204,840232916
4270000,2956067959,21673271,2.9258915850000004e-12,175518846,5555892,845788808
4275000,2302826000,21626022,2.9195129700000002e-12,173983261,5514424,851303232
4280000,2382363417,21675076,2.92613526e-12,175577497,5549172,856852404
4285000,2254114292,21666787,2.925016245e-12,175308114,5549368,862401772
4290000,18441393958,21940287,2.9619387449999996e-12,174600281,5532404,867934176
4295000,3960992250,21672260,2.9257551000000002e-12,175485975,5555864,873490040
4300000,2116829291,21763259,2.9380399649999998e-12,173873660,5518376,879008416
4305000,2295212875,21662794,2.92447719e-12,175178348,5531356,884539772
4310000,2353142917,21626047,2.9195163449999997e-12,173984050,5526416,890066188
4315000,2257425375,21764296,2.9381799600000004e-12,173907359,5529000,895595188
4320000,2788750042,21611281,2.917522935e-12,173504155,5516176,901111364
4325000,2228057541,21623160,2.9191266e-12,173890222,5523116,906634480
4330000,2816748708,21609818,2.9173254300000005e-12,173456616,5518636,912153116
4335000,2262604958,21782220,2.9405997e-12,174489883,5534968,917688084
4340000,2475435417,21607078,2.91695553e-12,173367574,5507156,923195240
4345000,8898660167,21766650,2.93849775e-12,173983869,5526896,928722136
4350000,2137580000,21645193,2.9221010550000003e-12,174606308,5533952,934256088
4355000,2114683375,21582850,2.9136847499999997e-12,172580174,5480532,939736620
4360000,2535707208,21811508,2.94455358e-12,175441754,5558036,945294656
4365000,2287688000,21498625,2.902314375e-12,169842858,5437292,950731948
4370000,4768193584,21482443,2.900129805e-12,169316943,5424832,956156780
4375000,2061528750,21420625,2.8917843749999997e-12,167307858,5377696,961534476
4380000,43146558208,611682175,8.2577093625e-11,168458171,-273400256,688134220
4385000,2210654542,21520094,2.9052126899999998e-12,170540594,5436968,693571188
4390000,2291817917,21608778,2.9171850300000002e-12,168521457,5399516,698970704
4395000,2187556042,21517829,2.904906915e-12,170466962,5435544,704406248
4400000,2051499542,21590733,2.914748955e-12,172836355,5495420,709901668
4405000,2058632250,21667521,2.925115335e-12,175331978,5528132,715429800
4410000,2214816375,21617419,2.918351565e-12,173703640,5525784,720955584
4415000,2889750167,21614343,2.917936305e-12,173603688,5523264,726478848
4420000,2081789166,21600265,2.916035775e-12,173146160,5516276,731995124
4425000,2290118292,21740133,2.934917955e-12,172790497,5498256,737493380
4430000,5211077209,21633433,2.920513455e-12,174224092,5531884,743025264
4435000,2403311125,21602123,2.916286605e-12,173206540,5505760,748531024
4440000,2308337875,21658456,2.9238915599999997e-12,175037364,5535252,754066276
4445000,2322384959,21584545,2.9139135750000005e-12,172635235,5490708,759556984
4450000,2278833750,21672119,2.925736065e-12,175481412,5552220,765109204
4455000,2231626333,21787096,2.94125796e-12,174316779,5514152,770623356
4460000,2246488375,21608871,2.917197585e-12,173425833,5526736,776150092
4465000,2127667875,21653881,2.9232739350000003e-12,174888647,5556988,781707080
4470000,2069709792,21763279,2.938042665e-12,173542752,5526984,787234064
4475000,2063655250,21641380,2.9215863e-12,174482380,5550880,792784944
4480000,2248993834,21610925,2.917474875e-12,173492602,5528004,798312948
4485000,2951777667,21589413,2.9145707549999996e-12,172793466,5514368,803827316
4490000,2280302541,21796184,2.94248484e-12,174612147,5552788,809380104
4495000,2449709750,21608878,2.9171985300000003e-12,173426062,5521544,814901648
4500000,2124218625,21606297,2.9168500950000003e-12,173342204,5522576,820424224
4505000,2985263125,21792077,2.9419303949999997e-12,174478671,5543780,825968004
4510000,2229640708,21610373,2.917400355e-12,173474644,5516560,831484564
4515000,2374695750,21543813,2.908414755e-12,171311475,5470064,836954628
4520000,2048224625,21645757,2.922177195e-12,169723273,5431404,842386032
4525000,2333149333,21460307,2.8971414449999997e-12,168597508,5393256,847779288
4530000,2246933167,21463337,2.8975504950000004e-12,168695977,5399944,853179232
4535000,2461867291,21527893,2.906265555e-12,170794040,5456228,858635460
4540000,2197023958,21774901,2.939611635e-12,173920449,5524556,864160016
4545000,2869512584,21621011,2.918836485e-12,173820386,5515968,869675984
4550000,2142904208,21603913,2.916528255e-12,173264725,5509924,875185908
4555000,2181425667,21594481,2.9152549350000002e-12,172958156,5481876,880667784
4560000,2063718708,21672731,2.925818685e-12,175501294,5557188,886224972
4565000,5843353125,21589664,2.91460464e-12,172801606,5501916,891726888
4570000,2037714167,21765461,2.9383372350000003e-12,173613667,5517804,897244692
4575000,2458191833,21641017,2.921537295e-12,174470600,5534760,902779452
4580000,2049782917,21614279,2.9179276649999996e-12,173601594,5519132,908298584
4585000,6453382958,21671960,2.9257146000000003e-12,175476217,5553248,913851832
4590000,11122369584,21891004,2.95528554e-12,172792461,5505616,919357448
4595000,2073739959,21622057,2.918977695e-12,173854389,5528908,924886356
4600000,2927924833,21636559,2.920935465e-12,174325712,5535444,930421800
4605000,2071227834,21633859,2.920570965e-12,174237952,5523172,935944972
4610000,2337604709,21613796,2.91786246e-12,173585890,5521012,941465984
4615000,2242891250,21600117,2.916015795e-12,173141332,5511156,946977140
4620000,2920790167,21815086,2.94503661e-12,175226478,5557440,952534580
4625000,2269776625,21602252,2.91630402e-12,173210726,5512852,958047432
4630000,2278714709,21658487,2.923895745e-12,175038356,5550764,963598196
4635000,2282919750,21611163,2.9175070050000003e-12,173500331,5509372,969107568
4640000,2174349750,21775403,2.939679405e-12,173936772,5521132,974628700
4645000,2063207500,21615269,2.918061315e-12,173633761,5514880,980143580
4650000,2298775250,21773479,2.9394196649999997e-12,173874255,5521576,985665156
4655000,11542771625,21824976,2.94637176e-12,175547879,5554844,991220000
4660000,2105517083,21585109,2.913989715e-12,172653556,5513176,996733176
4665000,2770224541,21650236,2.92278186e-12,174770215,5554180,1002287356
4670000,2076496709,21470945,2.898577575e-12,168943241,5422744,1007710100
4675000,3044103000,21649429,2.9226729149999997e-12,169842616,5439312,1013149412
4680000,2140447250,21442558,2.89474533e-12,168020663,5400676,1018550088
4685000,2378264791,21465934,2.89790109e-12,168780389,5417076,1023967164
4690000,2252002500,21627557,2.9197201950000003e-12,169131787,5425436,1029392600
